4 145 155 5 8 7 5 262 262 23 234 235 236 237 239 128 287 175 105 218 67 68 39 42 39 40 41 42 246 46 45 46 218 80 112 80 210 209 330 109 106 131 102 103 96 93 96 298 137 133 134 122 112 106 109 90 43 131 102 103 104 200 20 219 129 127 130 112 93 101 93 91 45 131 102 103 104 144 160 142
4 48 49 6 36 75 24 92 21 92 93 56 57 54 22 11 44 75 24 46 41 34 6 76 39 78 58 100 106 97 98 100 97 106 100 97 98 106 100 95 100 106 100 97 98 106 100 97 106 100 109 111 110 112 114 86 117
4 22 6 7 20 16 47 47 47 47 47 47 47 65 65 41 54 65 53 16 16 8 8 47 47 47 47 47 47 65 65 41 54 41 53 65
4 5 87 54 30 45 24 25 26 27 28 27 19 22 33 10 100 38 56 57 74 14 15 77 17 41 19 22 21 19 131 130 129 34 51 52 53 60 63 62 10 112 121 65 83 91 92 97 70 95 11 93 12 56 97 25 80 16 17 122 80 108 109 116 116 110 123 114 87 7 7 8 66 79 83 100 107 108 109 122
4 66 60 126 5 128 142 7 8 9 10 11 12 122 14 84 16 17 17 25 26 27 28 32 30 126 32 33 34 35 6 36 37 38 126 68 40 41 42 43 44 45 46 47 48 49 50 51 52 53 54 55 56 68 58 59 60 61 70 60 40 41 42 43 44 45 46 47 48 49 50 51 52 53 54 55 56 68 58 59
4 6 18 28 9 10 30 11 12 13 14 15 16 17 32 19 92 27 22 83 23 25 6 27 11 9 29 30 12 40 41 42 43 44 45 41 47 48 49 74 51 52 55 56 57 58 54 18 42 43 44 45 27 47 48 49 41 51 52 55 56 57 58 54 18 42 43 44 45 27 47 48 49 74 51 52 55 56 57 58
4 6 8 45 23 42 22 63 18 12 13 12 13 17 18 23 42 22 63 18 12 13 12 13 15 28 40 44 30 22 63 18 56 59 49 49 8 60 50
4 9 126 190 17 16 17 85 40 21 20 6 29 44 141 140 146 31 20 21 28 29 40 73 64 81 57 75 77 76 78 17 41 136 137 185 27 28 29 77 76 78 21 20 21 34 35 36 37 36 37 39 126 39 34 35 36 37 25 39 37 44 77 76 78 20 21 28 40 54 136 23 98 124 31 126 127 128 120 120
4 11 7 8 9 45 45 70 6 70 15 17 18 19 20 21 25 26 27 28 29 30 31 11 34 35 36 89 38 39 40 41 42 43 46 26 27 28 29 30 31 11 34 35 36 11 38 39 40 41 42 43 46 26 27 28 29 30 31 11 34 35 36 11 38 39 40 41 42 43 46 26 27 28 29 30 31 33 34 35
4 9 8 11 74 39 18 41 33 50 49 52 53 53 45 44 41 19 15 18 58 22 41 44 43 44 45 52 53 63 64 66 67 68 69 19 18 73 76 76 74 75 77 18 79 77 73 76 8 18 62 43 44 49 24 62 8
4 5 70 80 32 14 46 15 33 91 41 93 92 93 91 41 23 9 10 32 14 46 27 28 29 91 41 93 92 93 91 41 49 51 52 63 64 60 74 74 68 69 72 73 71 55 74 59 60 52 59 60 64 52 37 59 60 55 67 74 74 71 72 73 71 52 68 70 23 52 67 74 74 63 64 93 92 93 80 65
4 14 7 8 9 10 11 12 13 14 51 16 17 18 19 20 15 52 23 24 25 26 27 28 30 96 50 9 10 11 12 13 9 10 11 12 13 14 15 16 17 18 19 20 51 52 23 24 25 26 27 28 30 96 123 71 124 127 128 124 127 39 60 11 12 13 9 10 11 12 13 14 15 16 17 18 19 20 15 52
4 118 5 6 7 121 5 11 16 83 84 86 86 87 88 89 90 91 92 93 94 95 96 97 98 99 22 20 21 11 12 74 75 76 77 78 13 14 15 16 17 18 57 19 20 21 11 121 100 53 67 68 69 70 71 72 73 74 75 76 77 78 13 14 15 16 17 18 19 20 10 32 33 121 26 34 35 36 37 38
4 6 167 8 9 12 13 98 99 100 101 78 16 106 104 94 94 59 73 194 97 96 49 128 24 132 19 20 21 22 23 24 25 26 27 28 29 30 31 32 33 34 47 49 52 136 200 25 54 92 55 56 58 59 60 61 62 63 64 65 66 67 68 69 70 71 81 82 83 84 85 86 87 88 34 90 80 75 74 56
4 62 64 7 138 9 20 11 12 13 14 15 17 70 20 24 13 23 21 25 26 27 28 29 30 31 32 33 34 35 36 37 38 39 40 41 5 43 44 45 46 47 48 49 50 51 52 60 61 55 56 57 58 59 60 54 62 63 65 69 67 5 71 86 80 74 75 76 77 78 79 73 81 82 83 84 85 86 87 88
4 150 6 97 11 12 15 77 78 79 80 81 82 83 84 85 86 87 88 89 90 91 92 93 94 95 96 97 98 99 100 101 81 82 83 84 85 86 87 88 89 90 91 92 93 84 95 96 97 98 99 100 101 81 82 83 84 85 86 87 88 89 90 91 92 93 94 95 96 97 98 99 100 101 81 82 83 84 85 86
4 63 6 7 142 43 10 69 12 13 14 16 11 19 23 12 22 20 24 25 26 27 28 29 30 31 32 33 34 35 36 37 38 39 40 62 42 43 44 45 46 47 48 49 50 51 58 59 18 55 73 74 75 76 77 77 81 82 83 84 86 88 95 92 97 98 99 100 101 102 103 104 111 86 107 111 109 110 108 112
4 5 6 5 6 5 19 20 21 9 9 26 34 19 26 32 33 8 34 9 9 32 33 17 33 9 32 33 17 33 9 32 33 17 33 9 32 33 17 33 9 32 33 17 33 9 32 33 17 33 9 32 33 17 33 9 32 33 17 33 9 32 33 17 33 9 32 33 17 33 9 32 33 17 33 9 32 33 17 33
4 77 6 7 8 10 67 12 8 59 63 17 23 51 36 37 20 76 39 55 47 57 41 59 59 8 69 77 64 79 8 69 77 10 79 80 81 41 83 83
4 30 7 57 92 30 7 25 46 57 37 94 95 112 65 97 98 103 104 116 33 107 109 108 109 110 13 14 120 14 19 20 18 15 28
4 271 6 11 7 285 306 96 97 98 17 140 141 142 144 144 197 96 285 193 96 97 98 17 101 102 319 57 218 219 220 221 222 127 23 36 37 38 39 50 41 42 48 30 280 180 163 164 114 115 7 128 129 130 131 285 217 96 97 98 17 140 141 143 261 144 144 193 96 285 96 97 98 17 101 102 319 57 218 219
4 6 7 8 9 34 12 13 14 15 16 17 24 19 62 23 15 16 17 24 44 27 64 65 72 73 74 75 26 81 42 45 46 47 48 49 8 51 59 53 54 42 15 16 17 24 19 20 23 15 68 15 16 17 24 19 20 23 23 24 14 15 17 24 19 20 23 15 14 15 16 17 24 19 20 23 23 24 14 15
4 5 51 7 8 177 42 43 12 13 14 15 16 126 19 18 19 21 22 23 24 24 132 22 26 134 20 29 30 120 27 81 27 37 38 39 111 41 42 43 12 13 47 15 54 68 35 52 44 54 173 65 60 35 53 35 69 70 71 72 73 74 76 77 78 79 80 81 27 83 84 85 86 87 51 88 89 90 88 94
4 6 28 50 6 25 9 10 11 12 14 15 17 28 17 15 16 20 17 62 16 9 10 11 12 14 15 17 28 38 30 55 50 30 32 55 55 53 57 55 55 39 40 29 15 17 28 39 34 27 12 62 28 69 50 9 39 35 36 49 45 44 45 18 8 53 41 48 49 23 55 55
4 6 7 8 92 25 12 107 15 14 24 26 18 19 20 21 22 23 24 23 22 87 28 68 71 72 73 74 75 17 50 30 28 29 13 70 15 14 24 107 106 108 15 14 24 109 26 18 19 20 21 22 23 24 23 22 87 28 68 71 72 73 74 75 17 102 44 55 17 35 41 43 44 55 17 84 22 87 84 23
4 63 6 101 8 7 7 94 91 22 89 35 23 22 52 83 55 65 65 66 64 70 98 97 35 98 97 23 89 23 91 92 93 94 93 94 92 93 94 52 64 40 103 39 98 35 97 70 98 97 70 98 97 35 125 125 63 100 44 35 39 40 41 125 36 34 70 40 39 41 34 39 41 40 39 35 81 83 18 89
4 6 8 6 8 10 5 8 6 25 26 27 28 24 8 25 26 27 28 8 28 8 28 8 29 8 31 11 33 34 10 8 32 33 34
4 10 8 45 12 7 12 77 15 38 6 6 27 12 13 15 14 13 15 27 13 28 16 14 39 24 23 24 26 21 6 49 39 23 24 24 39 42 44 11 25 82 29 84 83 86 87 9
4 158 6 7 8 70 52 45 47 40 44 53 151 47 21 9 10 11 12 13 14 15 16 17 18 19 20 21 22 23 41 25 26 27 28 29 30 122 32 49 165 35 36 22 173 48 39 132 133 134 132 133 134 132 133 134 132 133 134 132 133 134 132 133 134 132 133 134 132 133 134 132 133 134 132 133 134 132 133 134
4 5 9 7 45 45 44 46 49 94 28 57 23 60 61 18 77 74 23 60 61 18 77 74 23 60 61 18 77 74 23 60 61 18 77 74 23 60 61 18 77 74 23 60 61 18 77 74 23 60 61 18 77 74 23 60 61 18 77 74 23 60 61 18 77 74 23 60 61 18 77 74 23 60 61 18 77 74 23 60
4 83 6 138 136 8 9 6 138 136 133 127 133 50 34 35 128 35 128 35 133 127 17 103 113 99 101 95 74 149 48 49 12 85 87 89 110 138 137 125 99 101 95 94 95 135 122 127 133 137 126 104 95 29 135 122 127 133 132 120 45 133 141 145 147 148 140 140 141 146 145 72 74 83 67 75 33 83 71 94
4 12 8 9 168 11 69 30 71 56 60 22 110 179 79 105 106 119 120 103 122 123 124 125 126 127 162 129 130 131 162 162 130 162 152 57 135 136 133 138 139 140 72 153 86 72 85 86 87 150 147 148 149 150 152 153 86 155 156 155 176 159 160 161 162 161 173 162 167 166 5 170 162 172 173 161 39 10 176 152
4 8 120 45 90 24 25 33 34 35 36 37 38 39 40 41 42 25 33 34 35 66 37 38 39 40 41 42 28 82 59 56 76 80 81 82 55 56 60 59 32 92 89 90 91 90 27 93 94 95 96 97 98 100 21 108 44 111 46 43 109 51 100 10 106 115 22 62 30 31 32 144 145 23 37 25 33 34 35 66
4 6 7 39 9 23 12 13 14 16 10 18 19 20 59 22 23 24 25 26 27 28 29 30 31 32 33 34 24 37 41 18 19 20 59 22 10 24 25 26 27 28 29 30 31 32 33 34 24 37 41 18 19 20 59 22 10 24 25 26 27 28 29 30 31 32 33 34 24 37 41 18 19 20 59 22 10 24 25 26
4 126 30 102 6 7 9 6 114 7 13 115 117 116 118 119 120 111 56 115 20 99 121 71 101 102 103 20 99 100 102 103 20 99 100 101 102 103 20 99 100 101 102 103 20 99 100 101 102 103 20 99 100 101 102 103 20 99 100 101 102 103 20 99 100 101 102 103 20 99 100 101 102 103 20 99 100 101 102 103
4 6 19 9 14 22 58 141 34 35 36 37 42 43 44 45 46 38 33 141 56 66 67 21 22 58 51 52 143 22 58 33 141 144 125 60 61 62 63 64 65 13 36 37 42 43 44 45 46 38 34 37 42 43 44 45 46 38 34 37 42 43 44 45 46 38 34 37 42 43 44 45 46 38 34 37 42 43 44 45
4 151 6 149 146 56 21 145 144 55 91 93 92 93 70 69 68 65 67 66 80 64 103 104 102 103 104 102 103 104 102 103 104 102 103 104 151 72 21 21 55 28 9 40 42 151 142 154 58 47 45 46 31 132 46 90 89 93 92 93 92 93 92 93 92 93 55 95 96 151 72 21 21 28 27 28 42 25 15 16
4 6 79 142 9 18 17 45 14 39 27 28 29 40 31 32 32 15 24 23 24 88 44 88 86 60 88 90 91 89 62 95 96 111 101 111 101 111 101 111 57 7 60 61 62 131 79 68 96 90 91 89 60 88 82 81 77 78 79 80 7 71 70 71 72 75 74 73 75 60 87 98 100 98 100 98 100 99 7 143
4 6 25 7 8 42 31 37 44 58 29 8 42 58 8 42 31 37 32 29 12 12 42 31 37 31 30 36 26 23 12 43 42 7 28 32 29 12 47 48 59 25 7 22 31 49 56 52 53 54 54 49 42 23 23 24 23 23 24 23 24 22 26 24 22 31 26 23 24 23 43 43 54 8 49 52 53 52 51 36
4 29 30 5 7 27 9 10 11 12 13 14 15 16 17 18 19 20 21 22 24 99 44 28 32 31 32 27 45 113 47 48 50 49 50 49 50 49 50 49 50 138 39 41 42 65 26 45 113 47 57 58 29 8 97 70 89 84 76 121 70 72 73 78 75 70 89 80 82 83 81 84 87 84 76 121 70 136 73 78
4 6 159 8 45 46 48 48 103 31 14 21 36 37 38 22 23 24 22 39 119 39 99 106 46 47 45 70 71 72 73 74 76 77 76 52 50 106 46 48 47 103 72 38 37 36 38 22 54 24 56 24 58 59 60 61 62 63 66 40 153 155 153 89 147 153 152 155 153 150 147 153 152 155 153 150 147 153 152 155
4 5 6 14 8 79 8 9 15 16 17 18 19 20 22 21 19 23 24 25 26 27 28 29 30 31 37 33 34 35 36 37 13 39 40 67 42 13 73 73 39 46 21 19 20 22 21 19 23 24 25 26 27 28 29 30 31 37 33 34 35 36 37 32 39 40 67 42 32 73 73 45 46 50 51 52 53 53 48 55
4 5 6 92 8 9 92 11 12 13 14 6 16 17 18 19 20 21 22 23 40 25 26 27 28 29 30 31 32 33 34 35 36 37 38 39 40 6 42 43 44 45 46 47 48 49 6 51 52 53 54 55 56 57 6 5 59 60 87 62 63 65 66 67 68 69 70 71 72 73 74 75 76 77 78 79 80 81 82 83
4 178 58 15 47 9 41 17 66 157 157 105 43 43 25 122 130 25 76 56 68 92 58 52 53 54 73 10 17 66 174 43 25 122 130 135 25 76 56 69 81 21 58 52 53 54 73 10 17 18 174 43 25 122 130 135 25 76 56 69 81 81 58 52 53 54 73 10 17 66 174 43 25 122 130 135 25 76 56 69
4 50 6 7 8 9 38 10 14 17 20 21 23 24 25 26 27 28 26 27 29 30 31 32 33 34 35 36 100 39 40 41 42 53 61 52 53 50 55 56 57 58 95 41 42 35 34 29 30 31 32 33 34 35 36 50 39 40 41 42 53 61 52 58 95 60 17 42 36 32 33 34 35 36 50 39 40 41 42 53
4 6 23 8 32 18 34 40 43 20 36 43 44 34 36 40 20 64 32 18 34 40 44 49 6 12 27 13 25 56 28 18 54 56 61 62 62 64 63 63 64 45 63 60 8 67 60 66
4 46 6 7 8 12 46 11 12 13 14 15 16 46 111 19 20 21 17 23 24 25 26 27 28 46 30 31 112 33 34 35 36 37 7 39 17 41 61 43 44 46 7 47 48 49 17 51 52 17 54 58 56 57 55 59 58 42 62 63 64 8 49 46 51 52 17 54 58 56 57 55 59 58 42 62 63 64 8 49
4 6 103 111 88 100 101 88 80 103 6 25 20 88 19 56 106 59 18 106 59 84 102 44 46 27 48 49 49 96 97 96 97 106 18 59 84 102 44 104 91 106 86 87 20 21 101 17 25 28 96 39 26 21 101 17 25 28 96 39 20 21 101 24 25 28 96 39 20 21 101 22 24 25 28 96 39 20 21 101
4 73 6 116 32 107 113 13 45 21 41 13 30 12 41 90 80 39 65 24 65 47 36 53 129 24 18 16 16 69 13 45 46 41 32 24 18 16 16 69 13 66 16 24 65 45 46 47 16 58 41 28 11 19 104 80 36 80 90 80 38 92 93 94 95 92 90 80 39 92 95 94 40 60 34 100 97 98 99 100
4 5 92 7 204 9 11 12 13 14 15 72 118 18 53 54 21 22 130 25 24 102 28 136 30 31 251 35 36 151 153 189 153 187 188 189 151 96 97 98 97 98 103 101 104 105 106 138 16 110 111 112 113 114 115 116 56 118 116 45 46 47 48 49 50 52 53 54 55 56 56 42 59 72 56 178 70 66 68 26
4 5 8 7 8 9 10 11 12 13 14 31 16 17 34 35 36 37 38 39 23 24 25 26 27 28 29 84 9 15 32 17 18 35 36 37 38 39 23 24 25 26 27 28 29 84 52 53 57 55 56 69 71 74 9 73 72 75 60 77 66 76 77 44 46 44 45 46 47 66 83 49 9 84 85 68 87 88 89
4 73 133 6 96 11 9 10 11 12 13 14 15 124 17 18 19 20 21 22 23 65 25 26 89 28 120 30 33 32 31 34 35 36 37 38 39 40 41 42 43 44 45 46 47 48 49 50 51 52 53 54 55 56 57 57 59 60 106 59 85 64 24 66 59 68 69 71 72 59 74 7 81 96 84 102 86 87 88 89
4 51 6 59 97 6 59 97 6 35 11 12 13 19 20 16 22 19 20 35 63 22 14 60 63 33 28 101 47 41 35 11 24 13 19 20 16 22 32 22 14 60 81 33 91 62 79 70 71 91 73 74 76 77 78 79 51 79 34 35 45 44 51 11 24 18 19 20 16 22 32 22 75 33 99 100 101 97 98
4 6 7 8 6 14 15 16 17 18 19 20 21 22 23 59 27 28 29 30 31 32 33 34 35 36 37 110 111 40 109 42 43 44 45 46 47 64 49 7 115 51 52 53 54 55 56 57 58 113 60 61 62 63 48 7 142 72 148 9 142 147 13 14 15 16 17 18 19 20 21 22 23 59 27 28 29 30 31 32
4 32 11 12 14 16 25 26 27 19 20 21 22 23 24 25 26 27 28 29 30 31 32 31 34 49 51 56 57 54 54 55 53 57
4 6 15 8 6 33 8 37 37 10 37 35 35 35 9 20 21 22 23 16 23 30 23 19 23 22 23 22 23 35 10 36 10 15 35 35 15 15 20 13 12
4 48 6 7 115 9 10 11 12 13 14 15 16 17 18 19 20 21 22 23 24 25 54 27 107 122 11 12 13 14 15 16 17 18 19 20 21 22 23 24 25 54 27 52 120 122 10 11 12 13 14 15 16 17 18 19 20 21 22 23 24 25 54 27 42 120 122 10 11 12 13 14 15 16 17 18 19 20 21 22
4 6 68 120 9 10 11 12 13 14 7 16 17 18 23 20 21 22 24 25 9 27 28 29 30 31 32 33 34 35 36 37 38 39 40 41 91 43 120 89 90 91 108 48 49 50 51 52 53 54 55 56 68 58 59 60 60 61 62 63 67 65 66 67 67 69 65 67 7 75 7 77 80 79 80 98 103 105 104 93
4 65 59 123 5 125 7 8 9 10 11 12 21 14 15 82 6 17 17 25 26 27 28 31 30 123 31 32 33 34 6 35 36 19 123 64 39 40 41 42 43 44 45 46 47 48 49 50 51 52 53 54 55 64 57 58 59 60 61 80 126 99 103 114 100 101 102 103 63 56 65 66 56 136 40 41 42 43 44 45
4 30 6 7 53 9 30 11 12 13 14 15 16 17 18 19 7 20 23 24 25 26 30 28 29 30 31 39 37 37 38 42 43 22 41 54 55 56 56
4 6 7 106 56 15 28 12 42 66 68 56 37 33 67 66 68 66 59 77 15 56 92 28 12 42 66 59 77 15 56 22 44 43 44 45 46 100 100 48 49 31 32 33 67 68 66 59 77 111 115 80 80 72 95 64 91 64 26 84 85 87 63 79 80 85 94 63 32 94 99 94 63 47 10 96 97 92 53 93
4 9 57 90 12 21 52 52 17 71 19 33 84 67 33 82 78 77 18 27 21 30 29 29 23 12 21 8 52 49 17 71 19 50 81 29 30 74 33 36 43 33 82 25 27 21 30 29 18 27 50 23 29 30 60 59 21 73 76 77 74 20 82 84 67 20 82 78 83 67 33 79 77 78 87 95 89 89 8 99
4 6 7 42 10 11 12 13 14 14 68 32 33 34 35 36 37 38 40 41 67 43 44 45 57 47 48 57 50 57 58 59 60 61 62 63 60 61 62 63 59 53 51 8 64 65 69 68 69 70 16
4 5 108 59 59 41 59 41 40 39 40 39 59 121 59 12 91 87 86 79 80 99 102 58 15 28 20 13 52 53 30 58 52 30 59 45 42 110 44 17 26 19 17 116 122 89 10 17 26 50 122 115 21 50 12 13 58 52 13 108 94 13 72 73 96 83 32 12 91 98 86 93 82 83 56 66 88 84 86 79
4 30 6 7 53 9 30 11 12 13 14 15 16 17 18 19 7 20 23 24 25 26 30 28 29 30 31 39 45 45 38 42 43 22 35 54 55 56 56
4 111 6 111 119 8 109 152 153 152 153 48 85 83 84 85 83 84 85 83 140 168 169 90 105 157 158 159 171 174 72 131 131 38 39 48 46 93 90 120 133 40 56 57 54 109 60 166 109 60 62 105 71 140 168 169 84 83 85 83 84 85 83 140 168 169 90 105 157 158 171 13 187 193 194 192 192 8 195 193
4 10 11 14 14 24 94 91 94 48 49 50 51 52 53 54 55 56 57 58 59 60 61 62 55 64 65 66 66 69 76 96 97 98 99 100 24 55 103 76 55 97 98 99 100 24 89 90 103 12 97 43 72 12 103 100 14 89 112 55 89 103 96 13 14 14 14 89 17 36 19 20 21 22 23 24 24 26 27 24
4 107 5 39 70 104 104 15 31 32 31 32 45 36 47 85 21 24 28 29 26 27 89 90 87 88 91 60 70 66 68 63 62 70 68 71 62 68 67 62 70 68 67 92 53 72 78 21 24 28 25 23 83 84 89 90 87 94 85 63 62 70 68 67 92 80 81 82 72 78 21 24 28 29 23 79 84 81 82 85
4 11 7 8 9 93 6 60 22 23 24 21 20 23 23 24 25 26 27 20 69 45 46 47 48 49 50 51 52 53 54 55 71 73 71 75 58 59 77 81 82 81 84 85 87 89 86 87 85 86 87 90 91 91 29 91 91 10 95 10
4 5 6 7 5 20 10 19 22 13 14 8 8 8 55 9 21 12 23 24 25 26 27 28 29 30 31 32 33 34 35 36 37 38 39 40 17 43 9 45 46 47 48 49 50 51 52 53 61 55 56 57 58 59 53 54 62 64 65 66 67 105 56 70 106 72 73 103 104 77 78 99 100 107 108 109 110 111 112 113
4 79 5 6 9 10 5 26 10 5 26 10 5 26 10 5 26 10 5 26 10 5 26 10 5 26 10 5 26 10 5 26 10 5 26 10 5 26 10 5 26 10 5 26 10 5 26 10 5 26 10 5 26 10 5 26 10 5 26 10 5 26 10 5 26 10 5 26 10 5 26 10 5 26 10 5 26 10 5 26
4 6 83 20 16 17 18 19 116 6 142 134 83 11 25 12 58 51 52 127 130 42 51 52 12 130 48 54 26 28 27 132 33 44 42 51 52 12 130 48 54 48 26 28 27 11 18 25 88 30 12 130 16 172 56 58 106 130 32 91 177 122 177 172 66 102 142 151 154 153 152 152 73 73 78 118 119 163 157 157
4 163 6 174 235 81 22 56 13 68 158 54 55 56 24 68 35 128 92 128 129 56 65 69 58 104 39 14 40 238 66 54 55 56 13 68 39 105 58 118 209 85 91 124 85 91 124 85 91 56 39 120 68 24 35 25 23 127 92 128 56 65 38 83 78 79 109 111 110 111 138 139 163 200 201 202 201 202 193 154
4 11 151 204 10 23 104 25 26 27 30 59 73 37 25 36 34 38 39 40 41 42 43 44 45 46 47 48 49 50 51 52 57 68 33 74 75 76 77 78 79 80 81 88 89 24 84 85 86 87 82 89 90 98 100 103 101 151 105 144 107 181 182 96 112 113 114 107 116 117 119 120 121 128 123 126 127 144 129 146
4 27 127 104 10 23 33 23 31 61 21 45 63 84 19 20 49 68 68 31 103 102 106 101 106 101 127 104 113 114 93 93 16 93 85 88 86 88 86 90 12 15 30 31 14 62 63 84 19 20 92 41 42 43 43 30 31 14 18 21 59 118 93 44 39 41 42 31 43 30 31 14 73 63 84 45 20 49 68 48
4 6 7 40 47 17 28 11 12 13 14 22 16 18 19 20 21 15 11 12 13 14 15 16 25 26 25 26 27 28 29 8 30 31 32 33 36 36 37 41 39 33 39 46 47
4 6 7 8 9 10 11 12 35 15 16 17 18 19 20 21 22 23 24 25 26 28 30 31 13 13 8 34 32 8 37 38 37 8
4 5 29 7 14 15 16 17 16 29 13 13 19 20 21 23 23 25 23 23 7 30 25 25 34 35 36 33 33 7 34 35 36 36
4 45 16 27 7 8 12 22 25 26 27 28 32 21 22 25 26 27 28 32 21 30 31 23 30 32 28 10 21 22 25 26 27 28 10 21 22 25 26 27 28 32 21 30 31 23 30 32 28 10 21 22 25 26 27 28 10 21 22 25 26 27 28 32 21 30 31 23 30 32 28 10 21 22 25 26 27 28 32 28
4 90 136 43 9 90 107 105 104 8 9 154 146 44 45 46 35 99 134 39 40 41 58 16 13 15 12 58 26 27 28 140 141 142 139 141 142 140 102 128 129 131 130 132 117 116 20 118 103 104 103 112 113 114 113 114 62 99 101 135 135 133 62 57 16 65 64 66 168 64 66 170 64 66 168 64 66 170 64 66
4 6 11 74 39 145 13 37 49 28 47 48 41 28 43 110 14 76 114 8 45 81 41 105 110 105 42 11 98 52 39 98 49 28 49 47 48 28 119 120 110 35 42 11 98 84 52 28 119 120 110 35 42 11 60 84 52 119 120 21 110 35 42 11 98 84 52 119 120 21 110 35 42 11 98 84 52 119 120 21
4 124 6 141 264 9 66 51 97 193 23 179 179 88 55 94 54 12 18 14 72 80 71 55 159 66 81 68 97 151 23 22 58 146 55 159 66 81 78 151 79 80 71 55 159 66 81 78 151 79 80 71 55 159 66 81 78 151 79 80 71 55 159 66 81 78 151 79 80 71 55 159 66 81 78 151 79 80 71 55
4 6 7 65 9 10 11 12 13 13 15 21 17 18 19 20 21 41 23 24 25 26 27 28 29 30 31 32 33 34 35 36 37 39 40 8 42 19 44 55 46 47 55 49 45 56 57 58 59 60 61 58 59 60 61 62 64 64 8 68 65
4 6 7 8 9 10 11 12 13 14 15 16 17 37 19 39 40 41 42 43 25 26 27 28 29 30 31 33 33 61 66 27 28 61 66 27 28 61 66 27 28 61 66 27 28 61 66 27 28 61 66 27 28 61 45 46 47 48 49 50 51 75 53 50 51 75 53 75 76 78 83 83 79 82 79 84 68 87 58 10
4 38 6 7 8 10 11 23 24 24 25 26 38 28 29 30 31 32 33 34 35 36 37 38 23 40 41 42 43 45 46 10 11 39 41 42 46 50 48 48 48 8 51 48 53 42 38 53 38 58 59 58 59 61 62
4 42 6 7 9 10 11 7 12 6 7 15 16 17 18 19 20 21 22 23 24 25 26 27 28 57 30 35 32 33 58 35 36 9 41 7 43 69 52 71 72 73 74 75 76 77 85 80 80 9 80 7 78 86 7 88
4 80 7 87 8 155 7 84 90 33 32 30 31 32 33 28 16 15 30 31 32 33 47 86 50 99 75 50 90 88 50 65 67 68 66 50 65 75 81 32 55 90 78 79 38 6 18 31 32 33 28 14 15 14 15 16 28 33 26 27 23 21 22 12 13 16 15 16 15 16 28 33 26 27 102 103 53 52 54 51
4 76 6 7 8 9 69 11 73 59 63 14 15 17 17 19 20 21 22 23 76 25 26 29 28 29 30 31 32 9 6 66 35 37 9 39 40 68 56 48 62 60 59 9 63 64 70 8 75 76 64 70 71 75 76 69 73 79 80 42 82 92 99 100
4 7 25 11 15 15 75 126 62 127 29 30 66 33 73 74 75 126 62 127 29 30 59 66 71 127 128 118 59 119 111 121 122 123 126 125 126 127 128 100
4 46 53 6 14 51 10 11 51 19 23 28 29 30 31 32 33 38 41 41 53 10 11 7 17 58 13 53 10 11 51 13 16 18 19 27 28 29 30 31 32 33 41 41 48 52 52 58 52 49 58 51 48 53 8 57 8
4 6 8 9 20 20 14 58 59 58 59 58 59 29 21 30 20 8 26 37 47 33 35 11 39 44 40 48 49 10 29 12 42 29 9 29 49 47 29 48 27 9 29 47 29 48 49 47 29 48 27 58 57 58 59
4 6 197 8 49 48 50 113 230 12 13 186 243 54 112 217 213 214 85 84 158 159 160 161 134 181 137 70 27 75 153 68 43 147 145 49 42 155 40 132 147 142 137 182 183 186 153 42 82 85 84 158 159 160 161 134 181 137 70 27 75 153 68 43 147 145 49 42 155 40 132 147 142 149 182 183 186 153 253 254
4 241 6 10 16 280 13 92 89 97 98 99 100 101 100 93 94 168 71 70 215 93 94 92 96 97 98 99 100 101 92 100 92 82 83 89 273 75 119 256 271 107 170 107 241 109 126 122 261 10 240 220 125 198 203 204 18 206 207 208 209 210 211 212 213 241 201 202 203 204 18 206 207 208 209 210 211 212 213 241
4 42 6 7 8 98 10 11 12 13 14 15 16 17 18 71 36 21 22 23 24 25 26 20 49 29 30 31 32 33 110 35 19 37 38 39 40 41 19 43 44 45 5 47 50 49 50 51 52 53 54 55 56 57 58 59 60 61 62 63 64 21 66 53 68 69 70 8 72 75 20 75 36 77 77 79 49 81 82 49
4 8 114 10 31 10 23 24 80 18 36 99 100 101 78 92 75 73 79 80 47 78 79 80 47 82 83 50 92 75 76 70 6 90 91 92 93 94 52 71 97 98 99 100 101 78 84 92 75 73 79 80 47 82 83 84 85 86 70 114 125 88 89 90 91 92 93 94 52 96 97 98 99 100 101 78 50 92 75 73
4 61 39 80 9 15 11 12 13 26 40 26 26 26 77 77 16 53 50 52 57 55 56 53 54 87 90 10 11 12 13 26 20 12 57 55 56 77 82 79 80 20 84 83
4 45 21 39 7 49 70 38 72 71 73 74 74 72 79 80 40 43 42 43 44 48 46 93 9 10 12 13 38 71 72 73 74 40 43 41 42 43 44 48 46 93 9 10 12 13 40 43 40 41 42 43 44 48 46 93 9 10 12 13 40 43 40 41 42 43 44 48 46 93 9 10 12 13 38 79 78 40 95 95
4 24 6 5 50 9 30 23 55 18 19 20 22 23 22 55 26 27 28 9 30 35 33 39 37 38 39 40 20 44 47 47 10 10 44 29 43 17 46 43 50 22 9 22 53 55 54 25
4 14 53 101 101 10 15 16 33 57 58 59 60 61 59 63 64 65 66 67 68 69 70 71 72 73 74 75 76 77 78 79 80 81 27 83 43 44 45 46 90 48 140 50 51 52 53 54 55 56 57 58 59 60 61 59 63 64 65 66 67 68 69 70 71 72 73 74 75 76 77 78 79 80 81 27 83 107 44 45
4 5 87 7 24 14 14 48 11 20 106 106 107 105 105 89 20 41 101 105 105 102 105 102 11 41 105 105 105 102 59 74 72 73 69 71 72 73 71 74 72 70 71 72 73 91 91 91 102 105 97 98 99 100 81 80 81 80 61 97 100 99 102 105 102 105 89 81 80 52 55 105 99 100 102 105 102 105 89 81
4 6 38 52 18 23 19 24 23 27 20 27 20 41 14 23 19 24 23 27 20 27 20 41 16 23 19 24 23 27 20 27 20 30 29 30 27 20 29 30 27 20 29 30 23 41 16 23 19 24 23 41 27 20 30 29 30 27 20 29 30 27 20 29 30 23 41 14 23 25 24 23 41 54 27 20 30 29 30 29
4 45 11 8 9 10 11 8 9 10 11 8 9 10 6 8 9 10 13 14 16 21 19 20 21 22 23 24 25 26 27 34 28 14 16 40 41 42 43 44 45 44 47 57 59 60 66 64 62 62 63 66 9 27 26 27
4 7 26 9 10 11 52 51 29 30 33 34 35 37 16 16 16 58 57 56 12 56 54 71 22 20 5 35 34 35 37 16 16 21 56 14 20 59 38 24 61 59 71 24 71 70 71 70 46 73 73 72 45 75 76 38 82 83 24 87 87 27 87 59 73 73 73 45 75 9 89 90
4 45 6 7 8 27 27 48 14 12 19 20 21 33 23 24 28 29 34 12 36 32 33 34 35 36 28 26 34 38 17 49 41 42 43 23 24 28 29 34 12 36 25 26 34 35 36 28 26 30 31 32 33 34 35 36 28 26 34 38 17 49 41 42 43 13 44 80 46 47 50 40 50 52 13 54 55 56 55 21
4 6 9 28 24 21 22 22 21 22 24 21 22 22 21 22 24 21 22 22 27 31 28 33 24 21 22 22 21 22 22 21 22 22 21 22 22 21 22 22 27 31 63 28 18 24 21 22 22 21 22 24 21 22 22 21 22 22 21 22 22 27 31 60 28 18 24 21 22 22 21 22 22 21 22 22 21 22 22 21
4 6 7 8 9 10 11 12 13 14 15 16 68 18 36 37 38 39 40 41 24 25 26 27 28 29 30 31 31 23 25 26 27 28 29 30 31 31 23 25 26 27 28 29 30 31 31 23 25 26 27 28 29 30 31 31 23 25 26 27 28 29 30 31 31 23 25 26 27 28 29 30 31 31 23 25 26 27 28 29
4 6 87 86 118 6 86 13 14 15 16 17 18 18 26 28 73 20 46 47 42 61 66 49 50 20 46 117 30 31 18 18 119 15 16 31 18 18 117 21 27 28 46 47 118 66 50 49 20 46 117 30 31 18 18 119 15 16 31 18 18 117 26 27 28 46 47 118 66 50 49 20 46 117 30 31 18 119 16 31
4 40 6 7 7 71 9 11 56 45 46 47 48 49 35 51 52 53 38 56 11 57 13 14 15 16 64 25 26 32 33 34 61 63 63 64 65 63 66 68 69 70 8
4 61 64 6 114 134 9 10 18 12 13 14 16 70 9 23 12 22 20 24 25 26 27 28 29 30 31 32 33 34 35 36 37 38 39 40 64 42 43 44 45 46 47 48 49 50 51 52 60 11 55 56 57 58 59 53 61 63 65 69 67 94 95 93 94 95 96 100 98 99 100 101 102 106 104 105 106 107 108 106
4 35 49 51 50 8 9 21 14 11 15 23 52 20 10 14 11 15 23 25 52 20 21 14 11 15 23 33 39 16 16 24 23 52 20 21 14 11 15 23 25 34 35 47 48 49 46 47 48 49 51 50 8 51 51 8 53 53 60 58
4 6 8 6 8 13 13 13 13 13 13 13 13 12 13 16 17 15 14 19 18 28 12 15 14 12 17 16 17 14 12 19 16 17 28 14 12 19 16 17 14 12 19 16 17 14 12 19 16 17 14 12 19 16 17 14 12 19 16 17 14 12 19 16 17 14 12 19 16 17 14 12 19 16 17 14 12 19 16 17
4 6 7 8 9 6 11 12 13 14 15 16 17 18 17 18 19 20 21 9 27 24 25 26 27 28 21 30 31 32 33 34 35 36 37 38 39 40 41 42 69 61 46 63 64 65 66 67 68 73 70 71 72 73 74 52 53 53 48 49 50 51 52 53 54 55 54 57 71 72 73 74 75 77 77 78 77 77 23 80
4 6 137 140 19 10 11 12 13 14 16 70 19 20 21 22 20 24 25 26 27 28 29 30 32 33 34 35 36 37 38 39 40 141 42 137 44 45 46 47 48 49 50 51 52 53 61 55 18 57 58 59 60 54 62 63 64 65 66 67 137 71 86 80 74 75 76 77 78 79 73 81 82 83 84 85 86 105 88 89
4 6 48 8 15 15 10 9 29 30 65 32 33 76 35 19 23 24 29 30 65 32 33 76 35 43 44 45 39 46 9 76 17 18 24 29 30 65 32 33 76 35 43 44 45 31 14 45 15 46 21 16 17 18 38 29 30 65 32 33 76 35 43 44 45 31 14 45 15 46 21 16 17 18 19 29 30 65 32 33
4 7 47 19 20 40 41 42 43 40 41 42 43 40 41 42 43 40 41 42 43 40 41 42 43 40 41 42 43 40 41 42 43 40 41 42 43 40 41 42 43 40 41 42 43 40 41 42 43 40 41 42 43 40 41 42 43 40 41 42 43 40 41 42 43 40 41 42 43 40 41 42 43 40 41 42 43 40 41 42
4 5 7 8 22 11 9 14 25 38 26 20 14 25 11 26 20 14 25 16 17 18 19 20 17 18 19 20 17 18 19 20 17 18 19 20 15 11 18 19 20 17 18 19 20 17 18 19 20 17 18 19 20 17 18 19 20 17 18 19 20 17 18 19 20 17 18 19 20 17 18 19 20 17 18 19 20 17 18 19
4 6 28 28 6 11 13 16 13 16 13 18 22 21 28 23 27 28 9 27 28 28 11 13 16 18 21 28 9 27 9 27 28 9
4 6 64 107 23 9 10 57 9 10 57 16 16 17 37 38 39 90 39 17 82 16 16 106 106 104 114 49 117 27 28 29 30 31 13 33 34 120 36 37 38 39 17 17 16 21 16 8 23 66 22 26 27 28 29 30 31 32 33 34 120 36 37 38 39 17 17 16 21 16 8 23 66 22 117 27 28 29 30 31
4 157 6 173 58 10 11 12 13 14 15 16 17 89 89 21 21 102 23 24 25 26 27 28 29 30 32 38 81 47 48 49 50 51 52 53 54 81 124 131 132 133 134 143 144 145 69 209 148 161 150 151 152 153 154 155 156 157 158 159 160 156 192 191 205 171 172 173 174 190 181 182 93 191 187 186 152 153 154 155
4 77 5 25 23 166 5 95 40 41 42 43 36 98 55 39 33 34 59 68 69 70 71 72 73 74 75 76 77 78 79 80 160 82 83 84 85 86 87 88 89 90 91 92 93 94 51 77 143 98 102 101 95 44 9 17 112 20 21 22 24 26 25 23 14 29 30 129 135 27 34 35 144 38 27 22 24 26 25 23
4 5 113 115 8 9 10 129 12 28 14 15 21 73 74 19 20 21 22 23 24 69 22 23 24 69 22 23 24 69 22 23 24 69 22 23 24 69 22 23 24 69 22 23 24 69 67 31 51 76 39 87 85 86 87 35 114 114 119 115 77
4 62 64 7 42 9 10 11 18 13 14 15 64 103 113 114 64 116 117 118 119 120 108 122 123 124 125 122 127 128 6 55 44 20 21 22 20 24 25 26 27 28 29 30 31 32 33 34 35 36 37 38 39 40 41 64 43 44 45 46 47 48 49 50 51 52 60 61 18 56 57 58 59 60 54 62 63 65 66 67
4 5 23 39 16 16 9 9 13 14 15 17 14 15 17 10 10 10 9 10 9 13 14 15 17 14 15 17 14 15 17 10 10 10 9 10 9 13 14 15 17 14 15 17 14 15 17 10 10 10 9 10 9 13 14 15 17 14 15 17 14 15 17 10 10 10 9 10 9 13 14 15 17 14 15 17 14 15 17 10
4 17 93 19 23 16 36 54 14 43 45 30 24 25 37 64 44 75 56 57 59 80 85 83 93 95 33 13 101 102 108 109 109 107
4 6 68 8 30 90 17 18 11 12 21 22 66 24 25 26 27 28 68 31 32 33 34 35 36 37 38 39 40 41 42 33 44 45 46 47 48 49 50 51 52 53 54 55 56 57 40 117 127 60 62 71 65 66 67 68 69 71 63 65 66 67 7 69 71 57 58 60 117 127 73 76 73 76 78 87 81 83 10 98
4 6 7 8 10 11 12 13 130 15 20 17 18 107 20 116 22 74 24 25 26 27 28 27 30 75 31 32 33 11 35 36 37 38 40 41 42 43 44 45 46 47 48 49 50 51 52 53 54 55 56 57 58 59 60 61 62 63 11 65 66 67 68 69 70 73 72 73 74 75 7 76 77 7 78 84 88 89 88 133
4 6 26 9 6 39 13 16 20 8 9 6 18 19 20 20 34 21 20 31 32 41 39 40 38 42 43 44 45 46 47 48 49 8
4 15 6 5 8 9 6 5 8 9 54 11 12 13 14 33 16 17 18 19 20 21 22 23 24 25 14 7 16 17 18 19 20 21 22 23 24 25 33 27 28 29 30 31 32 40 34 35 36 37 38 39 33 35 42 43 44 45 49 49 49 38 41 42 43 44 45 49 49 33 35 42 43 44 45 49 49 33 35 42
4 48 6 7 7 56 57 10 13 14 15 16 17 18 19 20 21 22 23 24 25 9 28 29 30 31 25 42 21 22 23 24 25 39 41 28 29 30 31 25 42 33 34 35 36 37 38 42 20 21 22 23 24 25 27 28 29 30 31 25 42 33 34 35 36 37 38 42 20 21 22 23 24 25 27 28 29 30 31 25
4 5 8 5 8 28 10 37 37 21 37 39 46 26 27 28 27 30 27 38 26 27 28 30 37 37 21 19 50 42 37 38 14 46 20 7 30 31 33 35 42 36 37 38 39 41 41 42 38 42 41 41 42 37 38 39 46 41 42 41 33 42 38 39 7 41 42 42 41 41 37 38 42 41 41 42 38 42 41 41
4 64 6 63 8 26 21 20 21 31 32 33 32 41 41 56 63 35 36 37 36 37 66 39 40 6 61 8 61 20 21 52 14 20 21 52 11 20 21 55 25 26 21 25 26 21 25 26 21 27 28 30 35 32 33 32 41 56 63 35 38 37 36 37 66 39 40 38 41 11 56 61 56 57 54 24 45 46 58 58
4 6 108 100 72 32 37 52 32 72 27 30 21 32 72 27 27 37 38 32 72 27 30 54 32 72 27 27 37 38 32 72 27 30 113 91 70 68 7 52 41 32 72 27 30 54 32 72 27 27 37 38 32 72 27 30 54 91 70 68 7 52 41 32 72 27 27 37 38 32 72 27 30 54 91 70 68 7 52 41
4 23 63 64 65 66 12 67 68 69 14 16 40 62 63 64 65 66 12 67 68 69 14 16 40 62 63 64 65 66 12 67 68 69 14 36 37 48 49 50 51 52 53 54 55 56 57 58 59 60 61 62 63 64 65 66 12 28 68 69 14 93 40 59 60 37 48 49 66 10 59 108 64 65 66 12 97 98 64 65
