4 5 12 16 17 15 5 5 9 17 19 9 17 21 16 10 20 9 10 19 9 17 5 21 16 17 19 9 10 20 9 17 21 5
4 21 10 14 15 16 20 21 10 14 15 16 20 21 10 14 15 25 20 21 10 14 15 16 20 21 10 14 15 16 20 21 10 14 15 16 20 21 10 14 15 25 20 21 10 14 15 25 20 21 10 14 15 16 20 21 10 14 15 25 20 21 10 14 15 16 20 21 10 14 15 16 20 21 10 14 15 25 20 21
4 11 16 5 7 7 7 5 9 14 9 12 12 12 17 9 14 12 12 17 9 14 12 12 17 9 14 12 12 11 14 9 12 12
4 9 19 15 18 17 18 19 17 18 19 17 16 19 17 16 19 17 16 19 17 16 19 17 16 19 17 16 19 17 16 19 17 16 19 17 16 19 17 16 19 17 16 19 17 16 19 17 16 19 17 16 19 17 16 19 17 16 19 17 16 19 17 16 19 17 16 19 17 16 19 17 16 19 17 16 19 17 16 19
4 9 6 7 15 16 25 11 12 13 14 15 9 17 19 25 23 31 32 23 24 25 25 27 27 28 30 31 32 21 13 12 22 14 16 17 19 18 21 13 12 22 14 16 17 19 25 23 31 32
4 7 9 10 11 12 10 14 8 15 16 17 18 17 18 15 16 17 18 7 11 12 13 14 15 16 17 18 15 16 17 18 7 11
4 5 13 5 13 21 5 13 21 14 14 24 25 26 10 21 14 14 24 25 26 10 21 14 14 24 25 26 10 21 14 24 25 26
4 18 6 8 10 11 9 15 29 30 31 31 31 32 6 8 27 25 24 9 11 9 18 11 9 8 29 29 31 31 32 18 13 11
4 19 7 8 9 10 19 16 13 25 15 16 14 21 19 20 21 22 22 24 17 19 27 28 29 30 31 31 30 31 30 31 30 31
4 8 13 9 7 9 10 8 12 24 22 23 19 24 22 23 12 24 22 23 19 24 14 8 23 19 22 23 19 15 14 10 8 19 22 23 19 19
4 19 8 10 43 25 39 27 42 43 19 21 28 30 35 30 17 37 46 22 40 42 27 39 25 37 46 22 26 27 39 43 25 44
4 6 6 9 10 11 12 13 15 24 25 19 20 21 22 23 21 22 18 25 26 20 21 22 23 21 25 26 20 21 22 23 25 26
4 6 7 6 7 8 9 10 10 11 8 9 9 10 11 9 8 9 9 10 9 10 9 10 8 9 8 9 10 9 10 9 10 11
4 8 6 13 14 24 25 8 15 27 29 11 29 18 11 26 27 28 29 16 34 20 13 14 26 27 15 28 29 11 29 18 11 12
4 55 6 7 8 9 10 11 12 13 14 15 14 18 19 20 21 22 23 24 6 14 27 28 29 30 31 47 33 34 35 36 37 38 39 40 41 42 43 44 11 46 32 48 48 49 61 51 52 53 61 57
4 17 6 7 8 17 10 19 11 15 15 15 20 21 15 15 20 21 15 15 20 21 15 15 20 21 15 15 20 21 15 15 20 21
4 55 6 7 8 9 10 45 12 13 17 15 14 18 19 20 21 22 23 24 6 57 58 52 53 54 41 54 62 58 52 53 61 41
4 5 8 5 8 5 6 8 5 6 5 5 5 8 5 6 8 5 6 8 5 6 8 5 6 8 5 6 8 5 6 8 5 5
4 6 13 10 17 10 11 12 7 14 15 10 9 18 19 19 22 11 24 24 26 27 28 11 26 7 27 15 11 12 7 14 15 26 27 28
4 5 18 16 18 16 25 24 24 18 16 24 18 16 24 18 16 8 24 22 16 24 22 16 24 18 16 24 18 16 24 22 16 24 18
4 6 7 8 9 12 13 28 42 54 44 20 85 24 26 27 29 29 43 31 45 46 36 69 51 52 53 54 57 54 18 45 24 26 27 14 29 43 31 45 46 36 69 51 52 53 54 57 54 44 45 24 26 27 29 29 43 31 45 46 36 69 51 52 53 54 57 54 44 45 24 26 27 14 14 43 31 45 46 36
4 7 7 7 10 6 11 12 17 18 15 7 13 14 15 7 13 14 15 7 13 14 15 7 13 18 15 7 13 14 15 7 13 14
4 6 8 9 9 12 9 12 9 12 9 12 9 12 9 8 12 9 12 9 12 9 12 8 9 12 9 12 9 12 9 12 9 12
4 6 7 8 8 6 8 8 9 8 8 9 8 8 9 8 8 9 8 8 9 8 8 9 8 8 9 8 8 9 8 8 9 8
4 13 6 14 15 18 13 14 21 8 9 13 14 15 14 18 12 13 14 15 18 12 13 14 15 18 12 21 8 9 18 12 13 14 15 14 21
4 5 16 5 16 9 9 11 12 18 19 11 12 23 21 22 23 21 16 19 11 21 22 23 11 21 18 10 18 11 12 8 9 16 19 11 21 22 23
4 7 9 6 7 9 15 11 16 12 13 14 6 7 16 12 13 14 6 7 16 15 16 12 13 14 6 7 16 15 16 15 16 17
4 18 6 51 8 9 29 15 20 22 29 22 42 28 30 26 28 30 31 31 51 36 10 24 33 12 22 15 20 44 28 30 26 28 30 31 31 51 36 29 24 46 12 22 24 46 44 28 30 48 31 51 36 23 24 25 32 46 44 28 30
4 8 12 7 17 7 17 15 14 18 14 18 14 18 14 18 15 16 12 15 16 12 15 7 17 15 14 18 14 18 14 17 15 16
4 7 9 18 9 18 9 9 18 9 18 9 10 18 9 10 18 9 10 18 9 10 18 9 10 18 9 10 18 9 10 18 9 10
4 34 5 6 9 10 11 12 13 14 15 16 17 18 19 20 21 17 23 24 25 26 39 28 29 41 31 32 33 63 71 80 54 67 57 58 7 72 51 74 41 23 24 25 26
4 13 23 22 14 7 15 12 25 27 21 16 7 11 12 22 27 21 16 7 15 12 22 23 21 16 7 15 12 22 23 21 16 7 11
4 15 6 7 8 9 10 11 12 15 14 13 16 17 18 15 20 21 22 23 24 25 26 27 18 29 30 31 32 33 34 35 36 37 38 39
4 19 27 16 7 8 9 10 8 9 12 31 15 14 39 25 17 14 8 9 12 11 13 15 14 39 27 26 29 32 14 8 9 25 32
4 13 5 12 14 5 12 13 18 11 14 18 5 18 18 11 14 18 5 18 18 11 14 18 5 18 15 18 11 14 18 5 18 15
4 25 7 9 10 10 10 9 11 10 9 23 13 13 21 23 13 6 8 11 10 21 14 23 13 6 8 11 10 9 21 23 13 9
4 25 24 17 16 25 21 13 24 15 25 21 13 27 25 24 15 25 21 16 24 25 21 16 25 24 13 25 21 16 25 24 13 27
4 5 13 7 10 5 21 11 10 5 21 10 10 5 21 10 10 5 21 10 10 5 21 10 10 5 21 10 10 5 21 10 10 5 21 10 5 13 10
4 5 6 7 8 9 10 11 12 12 14 18 19 5 25 26 14 17 18 19 12 17 18 19 12 17 18 19 5 25 26 14 25 26
4 30 6 7 8 9 10 11 12 13 14 15 16 17 18 19 20 21 22 23 24 25 26 26 28 28 10 30 11 12 24 19 14 15 16 17 18 19 20 21 22 23 24 25 26 26 29 28 10 30
4 14 5 6 7 8 42 75 15 15 16 17 75 19 20 21 22 42 24 25 26 77 28 29 30 31 32 34 35 36 37 47 39 40 41 23 24 25 13 28 28
4 5 6 7 8 11 11 12 13 14 14 16 17 18 16 17 19 20 21 14 20 21 14 20 21 14 20 21 14 20 21 14 20 21
4 21 22 21 7 19 17 39 15 30 31 32 33 24 31 25 25 32 36 33 31 39 37 22 30 9 8 33 24 31 25 32 33 24 31 25 25 32 20 33 31 39 37 22 30 14 32 30 8 33 24 31 25 32 36 33 31 39 21 22 30 14 32 30 8 33 24 31 25 32 20 33 31 39 21 22 30 14 32 30
4 25 13 14 6 15 16 28 22 19 20 21 22 23 24 25 26 31 31 30 32 20 12 42 38 39 40 41 42 36 22 20 41 42
4 5 13 7 11 13 18 19 14 14 5 11 13 13 18 18 19 14 14 5 11 13 13 18 18 19 14 14 5 11 13 13 18 19
4 6 37 8 9 55 30 16 17 18 19 20 21 22 23 24 25 26 27 28 29 11 31 64 33 34 7 38 39 31 64 33 34 7 38 39 31 64 33 34 7 38 39 31 64 33 34 7 38 39 31 64 33 34 7 38 39 31 64 33 34 7 38 39 31 64 33 34 7 38 39 31 64 33 34 7 38 39 31 64
4 10 6 13 11 6 20 11 19 8 9 8 10 8 18 19 8 10 8 18 19 8 10 19 8 10 8 18 19 8 10 8 18 19 8 9
4 6 22 11 24 14 16 21 14 9 20 24 14 16 21 20 24 14 21 11 20 12 24 14 16 21 20 24 14 21 11 20 8 6 19 20
4 6 7 14 15 16 14 18 19 13 83 20 9 23 27 10 25 60 58 45 46 47 48 49 50 51 52 53 54 7 55 56 67 58 45 60 61 62 63 64 63 66 34 35 36 69 88 72 73 74 75 80 77 78 79 80 82 81 83 76 77 78 79 80
4 5 6 7 8 5 20 12 13 14 7 16 18 19 22 23 22 10 42 43 44 45 46 45 15 36 37 16 42 43 44 45 46 47
4 10 6 7 8 10 11 12 10 14 10 16 17 18 10 11 12 10 14 8 16 17 18 10 11 12 10 14 8 16 17 18 10 20
4 15 8 8 10 11 12 13 14 15 13 14 14 19 20 21 22 10 10 12 19 20 21 21 22 10 14 19 20 21 22 10 14 15
4 15 6 7 13 9 10 11 13 14 11 20 17 18 19 20 21 22 23 24 34 26 27 28 29 30 32 22 25 35 36 37 38 29 30
4 16 8 9 11 12 13 13 11 12 13 9 15 8 9 15 16 13 9 15 8 9 15 8 9 15 13 14 10 11 12 13 9 15
4 17 17 12 17 12 17 17 12 17 17 12 17 12 17 12 17 12 17 12 17 12 17 12 17 12 17 12 17 12 17 12 17 17
4 8 7 6 7 8 9 11 12 14 15 16 17 18 19 19 21 21 17 18 19 19 15 16 16 17 18 19 19 21 21 17 18 19
4 14 11 25 23 8 9 11 6 13 14 11 16 18 20 20 21 25 23 26 8 9 21 25 23 6 23 21 25 7 26 16 18 20 21 25 7
4 16 6 7 8 16 10 11 12 13 14 8 9 17 19 25 23 31 32 23 24 25 10 27 27 28 30 31 32 21 13 12 22 14 16 17 19 18 21 13 12 22 14 9 17 19 25 23 31 32
4 9 26 7 9 12 24 9 12 13 14 15 16 17 18 19 20 21 12 24 34 26 27 28 29 30 31 32 33 25 26 27 28 29 30 31 32 33 9 26 27 28 29 30 31 32 33 34 26 27 28 29 30 31 32 33 25 26 27 28 29 30 31 32 33 25 26 27 28 29 30 31 32 33 9 26 27 28 29 30
4 12 6 15 12 15 12 15 11 18 19 11 11 11 11 11 11 11 11 11 18 19 18 19 11 11 11 11 11 18 19 19 18 19
4 26 26 7 16 15 30 32 14 21 32 12 28 30 16 15 30 32 29 30 32 10 10 21 10 10 12 28 30 16 15 30 32 29
4 11 7 8 9 11 12 13 14 15 25 21 18 11 20 21 22 22 22 24 25 19 20 21 22 22 19 25 19 20 21 22 22 19 16
4 6 7 15 15 25 20 21 22 24 23 25 10 9 8 31 15 15 27 28 29 30 31 9 10 9 8 31 15 15 27 28 29 30 31
4 10 27 7 8 21 22 10 13 14 15 16 17 18 19 20 21 22 13 25 10 27 28 29 30 31 32 33 34 10 27 28 29 30 31 32 33 34 10 27 28 29 30 31 32 33 34 10 27 28 29 30 31 32 33 34 10 27 28 29 30 31 32 33 34 10 27 28 29 30 31 32 33 34 10 27 28 29 30 31
4 28 27 12 15 13 28 27 12 15 13 14 13 20 15 13 19 12 15 13 19 12 15 13 19 12 15 13 19 12 15 13 20 12
4 8 6 7 6 10 11 12 13 14 15 16 21 18 19 22 21 9 23 19 22 23 19 22 17 20 23 19 22 23 19 22 23 19 22 17 20 23
4 11 11 17 18 7 14 12 7 13 7 7 11 9 10 17 12 7 14 12 7 9 10 17 12 7 14 12 7 9 10 17 18 7 11
4 42 6 7 14 9 18 19 20 7 14 17 18 19 20 17 22 39 25 27 10 29 30 31 32 33 44 35 36 42 20 39 25 41 42 43 34
4 7 6 9 10 11 12 13 14 15 14 18 19 20 21 22 23 24 9 27 28 29 30 22 32 33 34 35 35 24 26 27 28 29 30 22 32 33 34 35
4 31 6 7 8 10 14 10 26 19 20 20 21 29 30 23 31 32 33 32 33 31 32 33 31 32 33 31 32 33 31 32 32 33
4 8 8 11 9 8 11 10 12 12 12 12 17 17 12 11 10 9 8 11 10 9 12 12 12 18 17 17 12 11 10 11 20 8
4 15 6 8 11 10 9 10 8 11 12 10 9 10 8 11 12 10 8 11 10 9 10 8 11 12 10 8 11 10 9 10 8 11 12
4 6 8 15 10 11 12 13 15 16 14 6 8 15 10 11 12 30 31 29 14 34 35 33 34 35 22 23 24 6 16 31 30 31
4 9 14 18 17 21 16 18 17 21 22 21 22 21 22 17 21 22 16 16 21 22 22 22 21 22 22 22 21 18 17 21 22 16
4 20 7 13 9 10 11 12 13 14 15 16 17 19 29 25 26 27 22 27 30 30 30 30 30 29 25 26 27 22 27 30 30 30
4 20 7 8 11 12 23 14 15 16 17 18 19 20 22 23 14 15 16 17 18 19 20 22 23 14 15 16 17 18 19 20 22 23
4 6 11 7 11 12 11 12 11 7 6 11 12 11 12 11 7 6 11 12 11 12 11 7 6 11 12 11 12 11 7 6 11 12 11 12 11 7 6 11 12 11 12 11 7 6 11 12 11 12 11 7 6 11 12 11 12 11 7 6 11 12 11 12 11 7 6 11 12 11 12 11 7 6 11 11 12 11 7 6
4 19 6 12 10 13 12 17 11 19 12 17 6 12 10 11 19 12 17 6 12 10 11 19 12 17 6 12 10 11 19 12 10 6 12
4 11 9 13 16 11 10 7 8 16 9 12 18 9 11 16 11 18 7 8 9 12 11 18 20 11 16 22 7 8 9 12 11 18 20 11 22
4 19 6 17 18 11 12 24 25 12 35 18 11 12 19 19 19 17 19 28 11 12 12 19 19 19 25 12 19 19 19 12 18 25 12 19 19
4 7 26 26 22 30 29 29 12 30 12 30 22 23 23 26 22 30 30 29 29 12 30 12 30 22 23 23 26 22 30 30 29 29 12 30 12 30 22 23 23 26 22 30 30 29 29 12 30 12 30 22 23 23 26 22 30 30 29 29 12 30 12 30 22 23 23 26 22 30 30 29 29 12 30 12 30 22 23 23
4 5 6 7 8 5 10 11 12 13 23 15 16 5 18 15 20 20 20 22 23 5 18 15 20 20 17 14 5 18 15 20 20 17 14
4 5 6 15 8 5 10 12 13 14 7 16 18 19 21 22 19 24 25 26 25 28 29 25 31 32 33 34 25 31 28 29 25 31 28 33 34 25 36 37 7 16 58 59 60
4 15 6 13 12 13 12 13 11 8 9 10 11 12 13 13 15 16 10 11 8 9 10 11 12 13 13 12 13 11 8 9 10 11 12 13 13 15 16
4 21 7 21 8 9 10 36 12 13 14 6 16 17 18 19 20 15 17 23 24 25 35 36 15 29 30 31 32 33 34 10 36 24 25 26 36
4 7 8 8 17 18 9 11 9 10 9 11 10 9 7 8 13 18 19 9 10 9 11 10 9 7 8 13 18 19 9 10 9 11
4 6 7 10 17 10 23 12 13 14 15 13 9 18 19 19 22 23 24 26 27 28 11 26 27 28 24 26 27 28 23 26 27 28
4 10 29 13 24 11 15 15 15 25 17 19 19 18 18 18 16 18 18 16 18 18 18 16 28 13 11 15 15 15 21 17 20 19
4 8 6 7 8 8 12 10 11 12 13 14 11 12 13 14 11 12 13 14 11 12 13 14 11 12 13 14 11 12 13 14 11 12 13
4 36 21 44 9 39 14 35 37 44 12 22 37 44 12 22 39 14 35 39 14 37 44 12 22 7 14 39 14 35 25 37 44 12
4 7 7 11 10 9 13 12 13 12 13 12 15 9 13 12 12 9 13 12 12 9 13 12 12 9 13 12 12 9 13 12 12 10
4 14 6 7 8 9 30 15 20 21 12 35 32 33 34 35 25 27 28 29 30 30 29 33 34 35 35 25 27 28 29 23 33 34 35
4 21 6 7 8 9 10 11 12 13 14 15 16 17 18 19 20 5 22 23 24 25 26 23 24 25 26 23 24 25 26 23 24 25 26
4 7 8 7 33 57 57 16 18 54 37 21 45 27 28 23 54 15 10 39 40 45 22 22 53 25 37 21 45 27 28 11 54 15 18 27 28 11 54 15 18 27 28 26 54 15 18 27 28 11 54 15 18 27 28 11 54 15 18 27 28 11 54 15 18 27 28 11 54 15 18 27 28 11 54 15 18 27 28 23
4 12 24 10 7 9 10 73 61 14 41 41 47 18 63 28 53 75 82 82 43 36 53 16 14 41 17 43 65 67 63 47 38 82 61 14 41 17 14 41 17 43 65 61 82 43 36 26 16 14 41 17 18 65 67 63 47 38 82 61 14 41 17 14 41 17 43 65 61 82 43 36 53 19 14 41 17 18 65 67
4 16 17 16 17 18 19 20 19 12 13 9 15 16 17 18 19 20 19 12 13 9 15 16 17 18 19 20 10 12 13 16 17 18 19 20 19 20
4 7 6 8 9 10 11 12 19 12 16 15 16 17 18 13 20 21 21 9 10 11 12 19 12 16 15 16 17 18 13 20 21 21
4 12 34 8 7 34 9 10 12 12 13 14 15 16 17 18 19 20 28 23 24 25 26 28 29 13 14 15 16 17 18 19 20 28 23 24 25 26 28 29 30 14 15 16 17 18 19 20 28 23 24 25 26 28 29 30 14 15 16 17 18 19 20 28 23 24 25 26 28 29 13 14 15 16 17 18 19 20 28 23
4 9 7 18 8 8 8 18 7 12 8 8 8 18 12 8 8 8 18 12 8 8 8 18 12 8 8 8 18 6 8 8 8 18
4 13 8 6 7 8 6 13 16 11 8 6 16 13 16 11 8 6 16 13 16 11 8 6 16 13 16 11 8 6 16 13 16 11
4 16 17 9 10 11 12 13 16 17 13 19 18 16 17 13 19 19 20 13 20 11 17 13 19 18 16 17 13 20 19 13 20 19
4 12 12 12 12 12 12 12 12 12 12 12 12 12 12 12 12 12 12 12 12 12 12 12 12 12 12 12 12 12 12 8 14 14
4 37 40 41 45 46 47 58 44 17 18 19 30 50 77 56 64 65 66 67 81 69 70 82 76 86 75 77 56 64 65 78 74 81 69 70 82 76 86 20 77 56 64 65 78 74 81 69 70 82 76 86 20 77 56 64 65 78 80 81 69 70 82 76 86 20 77 56 64 65 78 74 81 69 70 82 76 86 20 77
4 6 7 11 12 14 9 18 9 21 22 23 19 25 27 21 22 28 28 24 18 17 18 9 9 21 22 27 24 18 18 19 25 27
4 23 7 13 14 15 18 18 26 26 25 21 20 21 26 15 18 15 18 26 26 23 24 25 14 18 15 18 26 26 25 21 20 21
4 6 7 8 9 6 59 12 13 14 8 16 18 38 26 27 28 29 30 31 32 33 34 31 29 33 34 35 36 29 38 39 15 31 27 28 29 34 31 32 33 34 31 32 33 34 35 36 32 38 39 15 31 27 28 29 34 31 27 33 34 31 29 33 34 35 36 29 38 39 15 31 27 28 29 34 31 29 33 34
4 29 8 17 64 43 19 12 54 22 21 52 9 10 38 40 14 38 64 43 19 41 40 14 38 22 17 10 19 25 25 58 44 40 22 17 36 10 54 40 14 54 64 43 19
4 19 5 6 7 17 9 10 21 12 13 14 16 21 18 19 17 22 22 21 19 16 19 12 13 14 16 21 17 18 19 21 17 22 21
4 6 7 8 9 10 45 12 13 14 15 14 18 19 20 21 31 23 24 6 14 27 28 29 30 22 47 33 34 35 36 37 38 39 40 55 42 43 44 11 46 47 48 48 49 54 51 52 53 54 41
4 7 15 10 9 12 15 14 16 11 14 16 16 16 16 16 16 16 16 12 16 15 16 16 16 16 16 12 16 15 16 16 16 16
4 10 11 10 11 10 11 10 11 10 11 10 11 10 11 10 11 10 11 10 11 10 11 10 11 10 11 10 11 10 11 10 11 10
4 41 5 6 5 14 9 27 12 11 13 8 17 16 21 18 19 20 15 22 38 24 26 10 28 29 30 31 32 33 34 35 41 20 38 25 40 41 42 33
4 6 7 8 9 10 11 12 13 17 15 17 18 19 20 21 22 23 6 25 26 27 28 29 21 46 32 33 34 35 36 37 38 39 40 41 42 43 44 45 46 47 47 48 49 50 51 52 49 54
4 12 13 14 8 14 11 15 16 17 21 10 24 25 26 27 29 30 10 23 24 25 26 21 10 29 30 30 23 24 25 26 21 29
4 38 17 8 10 33 20 34 45 15 16 17 9 16 17 8 10 7 37 20 13 23 46 38 17 18 10 27 37 42 34 45 13 23 46
4 8 19 5 19 12 15 13 15 15 9 10 38 24 20 38 19 24 18 38 14 27 8 12 15 16 25 20 38 19 16 14 27 8 12 15 28 27
4 28 21 11 7 7 12 27 18 18 18 28 29 24 17 18 18 28 29 24 27 12 25 29 27 21 28 29 34 17 18 18 28 29 24 27 29 25 29
4 41 6 7 8 9 10 11 12 14 24 30 29 43 40 41 42 44 24 30 21 43 40 41 34 33 38 39 40 41 42 44 24 30 21
4 20 24 24 12 9 10 11 14 15 16 27 18 21 31 7 23 23 8 26 29 28 17 30 31 32 33 34 35 36 37 38 18 21
4 16 15 5 6 7 10 12 13 14 12 13 10 12 5 5 5 16 15 14 14 12 5 5 13 14 12 5 5 13 14 12 5 5
4 6 17 18 9 12 13 12 11 14 19 15 16 7 8 22 22 17 9 10 13 12 13 14 19 20 7 8 22 22 17 10 13 12 11 14 19
4 6 7 8 9 10 11 12 13 26 15 17 18 19 20 21 31 23 24 6 41 58 52 53 50 55 61 62 27 28 29 30 31 47 33 34 35 36 37 38 39 40 60 42 43 44 45 46 32 48 48 49 54 51 52 53 54 55
4 5 6 14 15 13 9 12 16 17 15 13 9 10 12 8 15 14 9 10 8 15 14 9 10 8 15 14 9 10 8 15 13 9 10
4 23 26 47 6 26 19 47 23 26 25 47 34 34 52 20 25 47 15 27 20 25 20 15 47 15 22 15 27 20 25 22 15 47
4 7 6 7 8 9 10 12 12 11 14 15 17 18 19 20 21 19 14 15 17 18 19 20 10 11 11 19 14 15 17 18 19 20 21
4 6 7 8 9 10 11 12 13 14 15 16 15 17 14 14 14 14 16 15 12 13 14 14 16 15 12 17 14 14 14 14 12 15
4 6 7 12 13 14 15 16 17 12 13 14 15 16 17 12 13 14 15 16 17 12 13 14 15 16 17 12 13 14 15 16 17 10
4 5 6 7 8 36 5 11 12 13 36 15 5 17 18 19 20 21 22 5 24 25 26 27 28 29 30 31 32 33 30 35 36 35 9
4 17 28 5 6 13 9 22 11 13 14 18 16 20 20 21 22 14 24 25 26 27 28 28 27 28 27 28 27 28 8 24 25 27 28
4 29 21 6 27 29 22 12 14 16 16 24 19 22 24 19 22 19 22 19 22 24 19 22 24 19 22 24 19 22 24 19 22 19
4 7 22 23 32 17 22 41 28 40 33 11 22 23 29 43 44 40 22 23 12 40 24 22 23 23 12 40 12 40 22 23 23 12
4 11 11 9 10 11 10 15 11 10 15 11 10 15 11 9 10 15 11 10 15 11 9 10 15 11 10 15 11 9 10 10 11 11
4 8 6 7 7 8 10 10 12 11 8 8 8 11 10 12 10 8 8 8 10 12 10 12 10 8 8 8 10 12 10 12 11 8
