4 21 7 24 23 23 7 10 14 10 11 15 16 12 15 16 18 20 19 21 16 23 24 7 24 7 24 24 7 24 24 24 23 23
4 7 8 8 16 17 16 18 17 18 21 24 27 19 14 19 7 12 14 19 14 19 7 12 14 8 14 19 14 19 7 8 14 8
4 28 29 29 29 19 21 29 29 29 29 29 29 29 19 21 29 29 29 29 29 29 29 29 29 29 29 29 29 29 29 29 29 29
4 13 16 12 6 14 15 7 18 19 20 22 23 25 24 25 20 10 31 30 33 34 24 25 10 33 34 31 32 10 33 34 31 30
4 5 5 6 7 8 9 12 10 11 13 14 15 17 22 17 22 23 15 17 22 20 15 17 10 11 13 6 14 11 12 18 17 15 17 22 20 15 17 22 20 15 17 10 11 13 6 14 11 12 18 17 15 17 22 20 15 17 22 20 15 17 10 11 13 6 14 11 12 18 17 15 17 22 20 15 17 22 20 15
4 6 8 9 11 30 13 14 10 11 12 13 14 10 11 19 13 14 10 11 30 13 14 10 11 19 13 14 10 11 19 13 14 10 11 19 31 13 14
4 7 6 7 7 8 15 13 18 14 19 26 20 22 6 7 7 7 6 22 20 22 6 7 7 7 6 20 22 6 20 26 6 7
4 6 10 37 18 24 21 22 23 20 22 30 46 35 32 34 45 34 39 40 40 47 40 46 47 40 39 40 40 46 39 40 47 40
4 6 13 8 9 10 6 15 16 18 19 16 18 15 19 16 25 22 23 24 25 26 27 28 29 30 31 32 33 34 35 36 37 36
4 6 7 9 7 6 7 9 7 6 7 9 7 6 13 7 9 7 6 7 9 7 6 7 9 7 6 7 9 7 6 7 9 7 6 7 9 7 6 7 9 7 6 7 9 7 6 7 9 7 6 7 9 7 6 7 9 7 6 7 9 7 6 7 9 7 6 7 9 7 6 7 9 7 6 7 9 7 6 7
4 29 59 20 29 45 41 47 44 42 46 43 44 42 46 47 44 43 46 48 50 48 50 59 49 54 29 8 64 33 20 29 38 54
4 8 6 13 10 8 10 13 6 8 10 13 6 8 10 13 6 8 10 13 6 8 10 13 6 8 10 13 6 8 10 13 6 8 10 13 6 8 10 13 6 8 10 13 6 8 10 13 6 8 10 13 6 8 10 13 6 8 10 13 6 8 10 13 6 8 10 13 6 8 10 9 6 8 10 9 19
4 14 11 7 10 14 12 11 20 13 19 5 10 11 20 18 19 14 10 11 20 18 19 5 10 11 20 13 19 9 12 11 20 18 19 5 10 11 20 13 19 9 12 11 20 18 19 9 12 11 20 13 19 5 10 11 20 18 19 9 12 11 20 13 19 14 12 11 20 18 19 9 12 11 20 13 19 9 10 11
4 34 17 35 7 8 15 10 18 19 18 20 26 25 27 31 30 31 34 33 14 7 36 14 16 15 11 15 11 15 11 15 13 32
4 9 7 8 9 10 11 12 13 14 15 16 17 18 19 20 17 18 20 23 24 25 26 27 28 29 30 31 32 33 34 35 24 25 26 27 28 29 30 31 32 33 34 35
4 5 54 28 17 25 23 26 39 32 41 24 39 37 43 42 44 43 8 48 20 85 48 20 71 48 88 89 90 78 71 93 87 75 94 79 77 87 75
4 8 7 6 9 10 12 16 14 15 20 21 24 17 18 22 23 25 42 44 29 40 46 42 44 40 46 42 44 45 46 42 44 45 46 42 44 45 46 42 44 40 46 42 44 45 46 42 44 40 46 42 44 45 46 42 44 45 46 42 44 40 46 42 44 45 46 42 44 45 46 42 44 45 46 42 44 45 41 42
4 7 5 6 6 9 5 9 6 9 5 6 9 8 5 9 6 9 8 7 11 12 7 9 12 7 12 7 9 12 7 9 12 7
4 5 17 8 27 35 13 14 15 16 37 18 19 20 21 22 23 24 17 20 23 37 19 20 21 22 23 24 5 20 23 37 19 20 21 22 23 24 17 26 27 28 39 35 39
4 5 8 10 9 10 5 10 10 5 10 9 10 5 10 10 5 10 9 10 5 10 10 5 10 10 5 10 9 10 5 10 10 5 10 10 5 10 9 10 5 10 10 5 10 10 5 10 9 10 5 10 10 5 10 10 5 10 9 10 5 10 10 5 10 10 5 10 9 10 5 10 10 5 10 10 5 10 9 10
4 6 7 10 9 10 11 12 13 13 23 17 18 19 20 22 23 24 25 26 9 22 26 22 25 9 22 26 9 22 7 22 23 25
4 8 9 31 9 10 13 12 13 12 10 13 39 24 18 21 22 23 24 25 36 27 40 27 40 32 41 21 22 23 24 25 36 38 40
4 16 15 14 13 5 17 5 8 9 10 11 22 7 22 7 11 28 29 19 18 21 27 28 29 19 15 5 17 27 28 29 19 18
4 9 6 21 6 9 14 8 14 17 15 11 18 12 19 19 19 19 19 18 19 19 19 19 19 22 21 21 22 9 14 8 14 17 15 11 18 12 19 19 19 19 19 19 22 21
4 7 8 9 12 15 11 14 22 13 13 13 7 23 5 22 5 8 9 12 14 15 11 22 13 13 13 7 23 5 22 5 8 9 12 14 15 11 22 13 13 13 7 23 5 22 5 8 9 12 14 15 11 22 13 13 13 7 23 5 22 5 8 9 12 14 15 11 22 13 13 13 7 23 5 22 5 8 9 12
4 32 30 6 7 30 30 11 10 12 13 9 15 19 18 17 16 32 7 30 29 22 26 32 40 37 35 38 7 38 35 32 40 23
4 32 33 8 7 7 7 8 7 8 7 8 7 10 7 7 27 7 8 7 8 7 10 7 7 8 7 8 7 10 7 7 8 7 27 7 10 7 7 8 7 8 7 10 7 7 27 7 8 7 10 7 7 8 7 27 7 10 7 7 27 7 8 7 10 7 7 8 7 8 7 10 7 7 8 7 8 7 8 7
4 6 6 23 8 7 8 23 8 7 8 12 9 13 14 15 17 16 18 19 19 17 13 18 19 19 25 26 23 26 23 7 7 26
4 5 9 29 11 12 18 14 13 22 20 21 22 23 21 22 20 21 23 22 20 21 22 23 21 22 20 21 23 22 20 21 22 23 21 22 20 21 23 22 20 21 22 23 21 22 20 21 23 22 20 21 22 23 21 22 20 21 23 22 20 21 22 23 21 22 20 21 23 22 20 21 22 23 21 22 20 21 22 23
4 21 9 6 21 9 6 9 6 9 6 12 8 6 14 16 12 8 6 14 16 12 8 6 19 23 27 23 6 6 6 6 23 6
4 8 7 31 27 25 8 27 30 29 30 24 19 10 25 7 31 26 31 26 30 24 24 24 27 31 29 31 27 30 26 31 24 24 10 25 7 31 26 31 24 19 10 25 31 27 30 26 31 24 24 10 25 7 31 26 31 24 24 10 25 31 27 30 29 31 24 24 10 25 7 31 26 31 24 24 10 25 31 27
4 5 6 5 8 9 19 18 20 21 22 25 26 11 31 29 30 31 32 30 28 17 26 11 29 30 31 32 21 30 31 17 26 11
4 8 6 7 8 10 12 13 12 9 15 16 17 18 19 20 20 20 15 16 17 18 19 20 20 19 10 20 15 16 17 18 19 20
4 10 7 8 9 6 11 12 13 14 15 16 17 18 19 20 21 22 24 25 26 27 28 29 35 30 31 32 33 34 37 28 36 37
4 10 25 7 5 28 12 7 13 28 12 7 13 28 12 7 5 28 12 12 15 17 16 17 18 19 20 21 22 19 21 23 24 25 11 31 29 28 12 23
4 29 29 6 7 9 22 10 12 13 11 14 15 16 17 14 15 16 22 29 29 29 29 29 25 26 26 19 19 26 19 26 7 24
4 20 20 19 48 71 6 30 32 27 28 29 33 32 34 38 37 38 39 40 41 42 50 68 53 69 50 68 53 69 50 68 53 69 50 68 53 69 77 68 17 69 67 73 52 64 58 51 73 57
4 17 17 21 7 21 21 21 22 21 17 20 21 17 22 21 17 20 21 7 20 21 17 20 21 17 22 21 7 20 21 17 22 21
4 15 9 16 15 9 7 11 10 12 13 12 11 13 12 11 14 12 13 14 11 10 9 7 12 13 14 11 12 13 12 11 14 12 13 14 11 10 9 7 12 13 14 11 12 13 12 11 14 12 13 14 11 10 9 7 12 13 14 11 12 13 12 11 14 12 13 14 11 10 9 7 12 13 14 11 12 13 12 11
4 11 10 11 15 32 39 55 37 33 35 36 37 38 34 40 42 25 28 56 49 56 47 29 8 56 49 56 47 56 47 56 16 56
4 15 26 44 23 17 18 19 20 25 21 16 43 24 22 24 25 29 35 36 37 44 48 11 51 47 50 11 51 32 33 44 46 48 11 51
4 11 6 8 8 9 11 14 15 15 17 18 16 13 19 20 21 6 8 8 8 9 21 12 11 21 12 20 21 6 8 8 8 9
4 5 5 9 18 8 18 7 8 9 18 7 8 18 7 8 9 18 12 13 14 15 6 5 9 8 6 17 6 7 18 6 7 8
4 55 70 68 75 10 21 23 22 24 32 35 28 41 42 43 44 29 43 55 47 47 57 7 59 55 47 49 70 59 55 47 57 7 59 55 47 49 70 59 73 75
4 5 7 12 13 10 11 17 18 19 20 18 19 17 22 23 24 25 26 27 28 29 30 31 32 35 36 37 38 8 8 37 40 8
4 5 5 5 5 5 5 5 5 5 5 5 5 5 5 5 5 5 5 5 5 5 5 5 5 5 5 5 5 5 5 7 7 7 7 10 10 11 11 12
4 6 6 82 36 39 27 45 13 30 32 16 17 18 19 20 21 22 23 24 25 45 51 31 23 25 33 7 21 52 8 38 52 39 27 11 29 14 52 30 59 40 8 21 52 39 27 45 47 29 14 52 30 62 60 61 62 60 71 62 57 71 62 60 61 59 60 61 67 68 69 10 72 71
4 6 28 33 24 11 11 13 14 15 16 16 32 33 34 28 33 24 28 32 33 7 28 32 33 7 7 33 32 7 33 28 28 32
4 20 23 24 10 16 8 12 9 15 11 14 15 12 20 22 24 21 16 21 16 20 20 24 20 24 21 22 24 16 20 20 20 23
4 5 6 19 5 20 10 11 12 13 14 15 16 17 26 15 12 17 27 28 21 22 23 24 25 25 5 20 24 20 24 20 24 20 24 25 5 10 11 12 14 15 16 17 26 15 12 17 27 28 21 22 23 24 25 20 8 9 24 9 24 9 24 9 24 20 5 10 11 12 14 15 16 17 26 15 12 17 27 28
4 7 9 6 5 9 6 5 9 12 11 13 14 15 18 16 17 18 9 6 5 9 6 5 9 9 6 5 9 6 9 6 5 9
4 6 11 14 32 40 6 17 20 19 18 17 22 23 22 23 11 9 36 11 36 11 17 20 19 22 23 22 23 22 20 21 20 22 23 11 9 36 11 26 6 17 20 22 23 22 23 6 9 36 6 36 11 17 20 19 22 23 22 23 22 20 21 20 22 23 11 9 36 6 26 11 17 20 22 23 22 23 6 9
4 37 17 39 10 20 12 13 14 13 24 23 24 35 30 31 18 34 29 30 31 37 39 40 41 42 43 44 16 44 40 41 43 44
4 7 6 5 8 9 10 11 12 14 7 8 9 10 11 12 6 6 17 18 19 20 20 18 19 20 16 17 18 19 19 20 18 19
4 58 18 34 100 40 34 9 14 26 32 69 100 34 40 9 14 26 32 69 100 104 108 9 14 26 20 69 100 71 40 9 14 26 71 40 44 26 46 48 49 48 47 49 48 51 41 58 82 89 82 83
4 17 11 18 11 11 7 8 7 9 10 11 12 15 16 18 11 17 16 10 11 12 15 16 18 11 17 10 11 12 16 15 17 16
4 17 27 5 30 33 32 33 46 30 62 42 43 37 67 61 41 69 38 61 74 38 61 63 53 54 61 55 53 38 61 63 53 38 61 56 67 61 63 53 37 54 61 74 38 61 63 43 37 38 61 74 38 61 63 43 37 54 61 56 38 61 63 43 37 38 61 74 38 61 63 43 37 38 61 74 54 61 41 53
4 6 7 8 9 27 11 12 13 14 15 16 9 18 20 19 21 22 8 7 8 7 21 22 27 8 7 8 7 21 22 23 18 20 22 21 22 8 7 8 7 21 22 23 6 7 10 7 30 31
4 9 9 10 11 12 13 14 15 16 17 18 19 21 21 8 6 24 20 26 27 28 33 34 35 36 37 38 39 43 35 36 25 38 25 42
4 16 7 22 6 10 11 12 13 14 15 9 17 13 14 15 23 10 24 11 12 13 14 15 16 17 25 12 13 14 15 9 10 24 11 12 13 14 15 16 17 13 14 15 16 8 6 10 24 11 12 13 14 15 16 17 25 12 13 14 15 9 10 24 11 12 13 14 15 16 17 13 14 15 16 22 6 10 24 11
4 5 6 7 6 12 15 16 18 17 13 21 23 19 24 25 25 31 32 30 29 33 5 31 32 9 30 7 33 5 31 32 30 16
4 36 31 25 14 42 40 41 45 46 44 43 44 51 49 51 49 51 52 53 54 46 52 36 54 54 46 52 36 54 54 46 52 36 54
4 10 7 6 9 10 11 12 10 15 16 22 23 24 27 21 22 20 9 21 22 31 24 25 27 40 41 33 43 40 41 33 39 44 45 46
4 20 7 9 19 19 9 10 7 9 19 7 9 19 10 9 10 16 20 9 13 7 9 19 19 9 19 16 20 9 13 7 9 10 10 9 10 16 20 9 13 7 9 19 19 9 10 16 20 9 13 7 9 10 19 9 19 16 20 9 13 7 9 19 10 9 19 16 20 9 13 7 9 19 19 9 10 16 20 9
4 15 7 22 9 10 11 12 13 14 15 16 8 19 20 7 6 10 10 11 12 20 19 9 10 10 14 14 15 9 10 11 12 13 14 15 16 6 19 20 7 6
4 26 26 26 26 26 26 14 10 11 9 10 15 17 18 19 20 21 21 17 21 11 19 13 9 14 15 17 18 19 21 20 21 17 21 11 19 13 9 14 15 17 18 19 21 20 21 17 21 11 19 13 9 14 15 17 18 19 21 20 21 17 21 11 19 13 9 14 15 17 18 19 21 20 21 17 21 11 19 13
4 19 8 9 10 11 12 12 15 18 21 15 18 21 20 15 18 19 20 18 18 18 18 18 18 18 18 18 18 18 18 18 18 21
4 14 17 8 9 12 11 15 13 14 16 17 19 20 21 22 9 18 10 12 13 14 15 17 18 19 20 21 22 9 8 9 10 12 13 14 15 17 18 19 20 21 22 9 18 10 12 13 14 15 17 18 19 20 21 22 9 18 10 12 13 14 15 17 18 19 20 21 22 9 18 10 12 13 14 15 17 18 19 20
4 20 6 20 26 18 19 11 21 13 36 24 18 19 20 21 13 25 24 27 28 29 30 31 32 33 34 35 36 6 29 35 36 37 38 39 40 42 44 43 31 51 52 43 44 48 31
4 18 8 20 6 9 10 11 12 13 14 15 16 17 18 18 20 21 22 23 24 25 26 27 28 29 22 23 24 25 26 27 28 29
4 6 5 11 12 21 13 14 19 15 16 24 19 21 20 23 20 24 5 17 5 26 30 27 29 27 28 29 7 26 28 29 30 31
4 14 20 20 19 20 20 20 20 14 11 19 20 14 15 18 19 20 19 20 19 20 20 18 20 20 14 11 18 19 20 19 20 20
4 26 7 8 8 11 13 14 12 15 18 17 18 19 16 16 19 16 17 18 19 16 16 17 18 19 16 16 17 18 19 16 16 17 18 19 16 16 17 18 19 16 16 17 18 19 16 16 17 18 19 16 16 17 18 19 16 16 17 18 19 16 16 17 18 19 16 16 17 18 19 16 16 17 18 19 16 16 17 18
4 40 11 45 59 11 45 59 31 24 51 48 28 54 62 63 19 50 35 65 63 64 66 75 91 59 59 13 90 77 78 79 95 86 98
4 6 32 9 10 13 8 9 10 13 8 11 10 34 10 13 8 9 10 11 8 11 15 16 21 20 22 23 20 28 24 29 30 30 16 16 34
4 6 36 13 9 37 22 23 24 25 26 28 24 28 7 34 40 45 42 43 44 40 41 43 44 40 45 40 43 44 40 41 44 40
4 6 7 8 9 10 11 12 13 14 16 17 6 19 18 19 21 22 23 25 25 24 17 22 23 25 24 25 17 22 23 25 24 25
4 9 7 23 6 7 23 7 23 7 23 6 7 23 23 13 11 10 12 13 14 22 16 18 6 21 23 19 19 23 6 6 9 23
4 7 9 20 7 5 14 13 15 14 15 16 17 13 15 14 15 16 17 18 6 21 18 6 21 7 7 19 10 16 14 13 15 14 15 16 17 18 6 21 18
4 38 6 21 7 8 8 32 21 37 23 8 8 21 37 23 8 8 21 21 37 23 8 38 39 21 37 36 39 38 38 39 21 7
4 23 20 30 29 27 33 39 38 32 39 38 32 40 41 42 43 45 46 43 45 16 50 44 46 16 50 43 40 41 42 43 45 46 49
4 8 6 10 5 18 6 10 5 11 9 10 15 17 18 21 21 24 23 22 24 18 22 23 24 22 10 23 24 22 10 23 24 18
4 12 6 5 8 9 10 17 9 14 15 21 22 23 26 20 21 19 8 20 21 30 23 24 26 39 40 37 38 43 44 45 29 37 33 31
4 8 13 10 11 8 13 14 19 16 15 18 17 18 16 19 21 20 20 24 9 24 23 13 25 10 24 7 24 11 13 24 7 24
4 14 25 26 14 10 11 27 26 14 15 16 17 18 17 18 6 21 11 13 26 14 12 23 12 31 14 23 13 31 14 12 31 26
4 7 7 8 9 10 11 9 8 14 15 15 36 58 18 39 51 6 35 50 51 25 39 51 6 49 43 37 45 46 61 62 63 64
4 19 17 45 16 17 27 32 25 26 28 29 31 34 35 36 37 38 36 38 37 25 17 22 17 45 16 7 17 29 31 34 35 36 37 38 36 38 37 25 17 16 17 45 16 7 17 29 31 34 35 36 37 38 36 38 37 25 17 16 17 45 22 7 17 29 31 34 35 36 37 38 36 38 37 25 17 16 17 45
4 23 23 9 9 10 20 21 22 6 24 25 26 29 28 27 30 23 26 27 18 34 35 36 9 12 39 6 36 9 13 13 17 6
4 23 7 6 7 11 6 27 7 11 26 8 7 11 6 17 18 15 13 14 16 17 18 19 22 23 26 27 27 8 8 27 21 25
4 9 7 8 6 10 10 11 13 14 35 15 17 16 19 18 19 17 18 9 25 22 24 35 24 22 31 32 34 26 27 34 31 8
4 14 14 16 15 20 19 24 10 29 26 12 27 17 17 17 24 10 29 26 12 27 17 17 17 29 24 10 29 26 12 8 17 17
4 54 36 13 12 19 15 38 16 23 23 36 23 54 54 54 53 54 53 54 53 54 53 54 53 54 54 54 54 54 54 53 12 19 34 37 38 35 22 23 23 34 19 18 37 35 22 23 23 34 19 23 37 16 22 23 38 54 54 54
4 5 13 7 17 14 7 16 17 14 13 22 24 26 25 28 23 27 29 32 31 33 34 30 32 33 31 34 30 32 33 31 34 30 32 33 31 34 30 32 33 31 34 30 32 33 31 34 30 32 33 31 34 30 32 33 31 34 30 32 33 31 34 30 32 33 31 34 30 32 33 31 34 30 32 33 31 34 30 32
4 6 6 8 46 26 10 12 41 6 15 34 16 18 17 19 33 21 30 38 29 22 22 46 55 57 32 32 32 62 32 62 32 62 57 63
4 6 10 6 7 12 13 14 15 16 19 7 20 15 10 9 7 8 7 20 15 8 7 20 15 8 7 20 15 8 7 20 15 8
4 15 6 29 12 13 14 15 16 11 18 19 20 21 22 23 24 26 27 7 30 32 32 8 7 8 7 32 32 8 27 30 32 32
4 34 48 29 10 16 16 38 20 21 34 29 34 48 29 10 38 21 48 29 22 22 13 22 13 20 21 14 29 34 48 29 16 38 37 38 8 48 29 10 22 16 38 37 38 20 48 29 10 22 38 37 38 48 43 19 49 49
4 22 10 9 13 17 14 8 28 14 8 28 14 9 17 14 8 28 14 8 28 14 9 17 14 8 28 14 8 28 14 9 17 14 8 28 14 8 28 14 9 17 14 8 28 14 8 28 14 9 16 6 8 28 14 8 28 14 9 17 14 8 28 14 8 28 14 9 17 14 8 28 14 8 28 14 9 17 14 9
4 14 12 9 14 22 23 24 25 24 14 25 22 23 17 22 14 47 54 28 49 47 54 11 47 9 55 17 15 17 15 45 31 35
4 52 23 24 9 30 23 28 25 31 21 22 29 36 34 35 37 34 37 36 37 34 35 37 21 22 29 36 34 35 37 36 37 34 35 37 21 22 29 36 34 35 37 36 37 34 35 37 21 22 29 36 34 35 37 36 37 34 35 37 21 22 29 36 34 35 37 36 37 34 35 37 21 22 29 36 34 35 36 37
4 17 18 9 11 13 12 10 13 12 13 7 21 20 21 17 14 17 7 17 14 17 7 17 14 17 7 17 7 17 14 17 7 17
4 8 8 10 11 12 25 8 36 15 33 9 8 10 11 12 25 27 18 19 22 21 22 19 24 25 27 30 16 32 33 34 14 38 36 34 17 30
4 11 10 9 11 11 10 9 9 17 13 14 18 19 15 20 22 22 22 7 11 11 22 22 7 11 11 22 7 11 11 22 7 7
4 17 5 17 19 8 31 14 18 10 18 12 13 21 22 31 24 25 26 27 28 29 30 32 33 34 35 36 37 41 39 40 41 40
4 7 8 8 12 7 14 15 19 17 16 18 20 28 29 27 26 25 33 32 33 39 40 41 42 35 44 42 40 41 21 43 40 41
4 21 16 6 22 8 7 11 9 10 15 15 6 18 18 18 18 21 22 22 21 22 9 11 8 10 15 15 6 18 18 18 21 22
4 12 6 23 11 5 6 7 5 6 11 5 6 15 14 16 17 18 22 20 21 24 22 23 24 6 24 7 24 6 11 6 24 10
4 11 21 20 18 19 20 21 22 31 30 31 6 27 29 31 27 17 29 31 10 28 28 7 22 31 11 17 29 30 31 6 27 17
4 9 10 10 11 19 20 21 22 35 23 24 40 35 38 37 47 42 51 48 49 45 44 45 44 45 44 45 44 50 36 44 45 44 45
4 9 7 8 9 10 11 13 14 15 16 17 18 22 23 19 25 26 27 28 29 30 31 32 33 34 35 36 37 28 32 33 34 35
4 6 14 14 6 10 8 9 8 10 9 8 10 12 13 12 13 6 12 6 14 14 6 10 9 8 10 9 8 10 13 12 13 6
4 9 5 9 5 6 17 9 5 6 20 14 15 17 9 10 9 6 20 15 6 17 9 10 6 20 15 14 15 17 9 17 9 8
4 6 5 6 30 26 9 39 40 27 33 43 49 45 27 33 34 12 43 14 43 30 45 27 33 34 12 69 14 43 30 45 27 33 34 12 69 14 43 30 45 27 33 34 12 69 14 43 30 45 27 33 34 12 69 14 43 44 45 41 33 34 12 69 14 43 30 45 27 33 34 12 69 14 43 49 45 27 33 34
4 5 6 7 5 9 11 12 13 14 10 15 16 17 18 19 20 19 20 21 22 23 24 25 26 27 28 29 31 32 33 34 23 24 25 26 27 28 29 31 32 33
4 6 7 22 9 10 11 12 13 14 15 16 17 18 17 18 22 21 8 21 8 29 30 26 27 28 29 30 27 29 25 27 29 25
4 11 18 17 15 21 21 23 22 24 13 26 35 14 29 32 28 28 35 34 30 28 35 6 8 11 13 14 16 16 17 18 31 28
4 22 11 11 10 12 13 15 16 17 14 15 16 17 31 7 7 31 7 27 31 27 27 27 31 7 22 23 23 15 16 17 17 21 27 31 7
4 7 7 7 11 9 10 12 13 12 13 7 9 11 12 13 12 13 7 17 17 17 17 7 13 7 9 10 12 13 12 13 7 17 17 17 7
4 6 7 43 61 11 12 13 13 16 17 19 18 19 16 17 18 19 16 17 18 19 16 17 18 19 16 17 18 19 16 17 18 19 16 17 18 19 16 17 18 19 16 17 18 19 16 17 18 19 16 17 18 19 16 17 18 19 16 17 18 19 16 17 18 19 16 17 18 19 16 17 18 19 16 17 18 19 16 17
4 61 20 10 5 22 21 25 27 23 74 26 27 32 33 92 26 27 88 44 74 29 52 72 43 92 96 76 80 75 84 68 72 31 51 52 53 90 57 88
4 9 9 6 8 5 6 8 5 6 8 5 19 20 13 12 16 17 19 20 22 23 24 25 22 17 26 21 24 23 24 12 16 17 19 20 22 23 24 25 22 17 26 21 24
4 14 7 24 29 30 26 32 31 33 33 13 24 29 26 32 31 33 33 24 29 50 32 61 33 33 24 29 31 32 61 33 33 24 29 50 32 61 33 30 50 26 31 32 61 33 33 24 29 50 26 32 31 33 33 24 29 50 21 50 21 33 28 17 27 29 31 32 59 33 24 29 50 32 59 33 31 33 13 60
4 9 7 8 9 10 16 11 12 13 14 15 18 22 23 19 20 19 25 8 26 28 29 30 31 32 43 34 35 36 45 38 39 40 41 30 31 32 43 44 35 36 45 38 39 40 41 30 31 32 43 44 35 36 45 38 39 28 29 30 31 32 43 44 35 36 45 38 39 28 29 30 31 32 43 44 35 36 45 38
4 6 22 6 22 10 11 12 14 15 11 16 19 18 17 20 19 18 17 20 19 18 17 20 19 18 17 20 19 18 17 20 19 18 17 20 19 18 17 20 19 18 17 20 19 18 17 20 19 18 17 20 19 18 17 20 19 18 17 20 19 18 17 20 19 18 17 20 19 18 17 20 19 18 17 20 19 18 17 20
4 8 7 6 9 10 11 12 13 15 24 16 17 15 16 17 24 22 17 15 13 10 11 12 13 24 22 17 15 16 17 16 17 22 23 24 25 26 27
4 5 6 7 8 29 29 11 12 14 15 16 17 18 19 5 13 39 12 13 30 27 32 33 29 26 27 32 33 25 29 26 27 32 33 25 29 26 27 32 33 25 29 26 31 32 33 25 29 26 27 32 33 25 29 26 27 32 33 25 29 26 27 32 33 25 29 26 27 32 33 25 29 26 27 32 33 25 29 26
4 19 6 8 19 8 11 9 10 14 13 14 15 16 16 12 11 9 10 12 13 14 15 16 16 14 12 15 16 16 11 6 21 6
4 22 22 81 82 20 48 10 24 26 25 72 64 34 40 31 42 8 47 46 75 53 53 72 65 67 74 70 70 82 73 13 65 80 67 74 69
4 5 6 7 8 9 10 11 12 13 11 12 10 11 12 13 18 15 16 17 18 19 20 21 22 23 24 25 26 30 28 29 30 29
4 6 7 20 9 12 11 9 12 14 18 10 14 16 20 20 7 6 19 7 6 20 19 16 20 6 20 19 7 16 19 20 16 20
4 71 18 39 37 56 35 80 68 74 70 43 45 11 18 52 32 39 37 56 35 74 43 45 11 18 52 32 39 37 56 57 74 43 45 11 18 52 32 39 37 56 57 74 43 45 11 18 52 32 39 37 56 57 74 43 45 11 18 52 32 39 37 56 57 74 43 45 11 18 52 32 39 37 56 57 69 67 45 11
4 94 30 82 34 59 117 117 126 58 58 94 67 117 117 18 58 58 10 20 21 25 92 43 18 58 54 18 25 117 42 102 116 127 90 94 33 99 7 75 42 116 9 130 13
4 5 26 32 5 12 7 8 9 10 11 15 23 16 18 14 23 32 18 23 14 16 18 23 32 13 14 23 33 31 32 33 31 32 33
