4 5 6 4 5 6 4 5 5 6 4 5 7 5 6 4 5 5 6 4 5 5 6 4 5 5 6 4 5 5 6 4 5 5 7
4 5 7 14 19 22 20 22 22 20 22 19 22 20 22 22 20 22 19 22 20 22 22 20 22 19 22 20 22 22 20 22 19 22 20
4 5 6 7 7 7 8 5 6 7 7 8 5 6 7 7 8 5 6 7 7 8 5 6 7 7 8 5 6 7 7 8 5 8
4 5 6 4 5 5 6 4 5 5 6 4 5 5 6 4 5 5 6 4 5 5 6 4 5 5 6 4 5 5 6 4 5 5 6 4 5 5 6 4 5 5 6 4 5 5 6 4 5 5 6 4 5 5 6 4 5 5 6 4 5 5 6 4 5 5 6 4 5 5 6 4 5 5 6 4 5 5 6 4
4 5 6 11 7 10 10 11 7 10 10 11 7 10 8 10 11 7 10 10 11 7 10 8 10 11 7 10 8 10 11 7 10 8
4 5 12 7 8 11 12 11 6 13 13 9 9 11 12 11 6 13 9 9 11 12 11 6 13 9 9 11 12 11 6 13 9 9
4 9 6 8 7 8 6 5 10 11 9 7 8 7 6 8 10 11 9 7 8 7 6 8 10 11 9 7 8 7 6 8 10 11
4 7 11 6 10 12 12 5 8 9 9 8 9 9 8 9 9 8 9 9 8 9 9 8 9 9 8 9 9 8 9 9 8 9
4 11 7 10 5 12 13 5 10 7 10 5 12 13 5 10 7 10 5 12 13 5 10 7 10 5 12 13 5 10 7 10 5 12 13
4 5 8 7 6 8 7 6 9 8 9 7 8 9 6 5 7 8 9 6 7 9 8 9 6 7 5 8 9 6 7 5 8 5
4 5 6 8 7 6 7 5 10 10 9 11 5 10 10 11 9 7 6 7 8 7 6 7 5 10 10 11 9 5 10 10 9 11
4 5 6 7 7 7 6 7 7 8 9 5 8 9 5 8 9 5 8 9 5 8 9 5 8 9 5 8 9 5 8 9 5 9
4 5 6 7 7 8 8 8 8 8 8 8 5 6 7 8 8 8 5 8 8 8 8 8 5 6 7 8 8 8 8 5 8 8
4 5 8 10 7 8 11 12 12 13 11 11 12 10 11 10 8 11 12 10 5 12 10 11 10 11 7 8 11 12 10 11 12 13
4 5 4 5 4 2 4 2 4 2 4 2 4 2 4 2 4 2 4 2 4 2 4 2 4 2 4 2 4 2 4 2 4 2 4 2 4 2 4 2 4 2 4 2 4 2 4 2 4 2 4 2 4 2 4 2 4 2 4 2 4 2 4 2 4 2 4 2 4 2 4 2 4 2 4 2 4 2 4 2
4 5 15 16 7 7 14 15 16 17 10 14 13 13 19 5 12 19 12 14 15 16 14 10 12 19 13 19 5 12 19 12 14 15 16 14 10 13 19
4 8 9 10 10 10 11 9 8 9 10 10 10 11 9 8 9 9 10 10 11 9 8 9 10 10 11 9 8 9 9 10 10 11
4 6 8 16 9 15 7 8 17 9 19 20 17 7 8 12 9 19 20 17 7 8 12 9 19 20 17 7 8 12 9 19 20 17 7 8 12 18 19 20
4 6 7 8 8 8 6 7 7 8 8 8 6 7 7 8 8 8 6 7 7 8 8 8 6 7 7 8 8 8 6 7 8 8
4 6 6 7 8 6 5 5 7 8 6 5 5 5 7 8 6 5 5 5 7 8 6 5 5 5 7 8 6 5 5 5 7 8
4 5 6 7 4 5 5 6 7 4 5 5 7 4 5 5 7 4 5 5 7 4 5 5 7 4 5 5 7 4 5 5 7 4 5 5 7 4 5 5 7 4 5 5 7 4 5 5 7 4 5 5 7 4 5 5 7 4 5 5 7 4 5 5 7 4 5 5 7 4 5 5 7 4 5 5 7 4 5 5
4 12 9 8 13 8 9 11 9 8 13 8 10 10 11 8 13 8 10 10 11 8 13 8 10 10 11 8 13 8 10 10 11 8 13
4 5 6 4 5 5 6 4 5 5 6 4 5 5 6 4 5 5 6 4 5 5 6 4 5 5 6 4 5 5 6 4 5 5 6 4 5 5 6 4 5 5 6 4 5 5 6 4 5 5 6 4 5 5 6 4 5 5 6 4 5 5 6 4 5 5 6 4 5 5 6 4 5 5 6 4 5 5 6 4
4 5 7 8 9 15 20 21 10 6 19 8 14 17 10 6 19 21 8 14 22 23 24 5 10 6 19 8 24 5 22 23 24 5
4 5 6 7 12 12 12 5 7 12 12 5 7 12 12 9 7 12 12 12 5 7 12 12 9 7 12 12 12 5 7 12 12 5
4 5 6 10 7 10 9 7 10 7 10 7 10 5 10 7 10 7 10 7 10 5 10 7 10 7 10 7 10 7 10 10 7 10
4 5 8 11 9 8 9 8 11 9 8 9 8 11 9 8 9 8 11 9 8 9 8 11 9 8 9 11 9 8 9 8 11 9
4 5 6 6 6 7 5 6 6 6 7 5 5 6 6 6 7 5 6 6 6 7 5 5 6 6 6 7 5 6 6 6 5 7
4 8 6 7 7 14 15 12 18 19 11 19 11 19 11 19 11 19 11 19 11 19 11 19 11 19 11 19 11 19 11 19 18 19
4 5 7 8 7 8 7 5 8 7 8 8 7 8 7 8 8 7 8 8 7 8 7 8 8 7 8 8 7 8 7 8 8 7
4 7 8 6 5 8 5 5 8 5 5 8 6 5 5 8 5 5 8 6 5 5 8 5 5 8 6 5 5 8 5 5 8 8
4 5 6 7 7 2 4 5 5 6 7 7 7 8 5 6 7 7 8 5 7 7 8 5 7 7 8 5 7 7 8 5 7 8
4 5 6 7 8 11 9 10 11 14 10 11 14 11 12 13 14 11 14 10 11 14 11 14 13 11 12 14 10 14 11 14 13 14
4 5 6 5 8 6 5 8 6 5 8 6 5 8 6 5 8 6 5 8 6 5 8 6 5 8 6 5 8 6 5 8 6 5
4 5 11 10 9 8 9 11 9 8 9 11 10 9 8 9 6 11 9 8 9 11 9 8 9 11 10 9 8 9 11 9 8 9
4 5 6 6 6 5 7 7 7 5 7 6 6 5 7 6 5 7 6 5 7 6 5 7 6 5 7 6 5 7 6 5 7 7
4 8 20 17 23 10 21 24 10 9 21 14 21 9 23 24 10 9 21 14 21 9 23 24 10 9 21 14 21 9 23 24 10 9
4 5 6 7 8 7 6 7 8 7 6 7 8 7 6 7 8 7 6 7 8 7 6 7 8 7 6 7 8 7 6 7 8 7
4 5 7 7 7 5 6 6 6 7 6 6 6 7 6 6 6 7 6 6 6 7 6 6 6 7 6 6 6 7 6 6 6 7
4 2 4 2 4 2 4 2 4 2 4 2 4 2 4 2 4 2 4 2 4 2 4 2 4 2 4 2 4 2 4 2 4 2 4 2 4 2 4 2 4 2 4 2 4 2 4 2 4 2 4 2 4 2 4 2 4 2 4 2 4 2 4 2 4 2 4 2 4 2 4 2 4 2 4 2 4 2 4 2
4 7 18 12 23 24 10 19 10 21 23 24 9 10 8 25 19 10 23 10 24 9 10 8 25 19 10 23 10 24 9 10 8 25 9
4 5 6 4 5 5 6 4 5 5 6 4 5 5 6 4 5 5 6 4 5 5 6 4 5 5 6 4 5 5 6 4 5 5 6 4 5 5 6 4 5 5 6 4 5 5 6 4 5 5 6 4 5 5 6 4 5 5 6 4 5 5 6 4 5 5 6 4 5 5 6 4 5 5 6 4 5 5 6 4
4 5 4 5 4 2 4 2 4 2 4 2 4 2 4 2 4 2 4 2 4 2 4 2 4 2 4 2 4 2 4 2 4 2 4 2 4 2 4 2 4 2 4 2 4 2 4 2 4 2 4 2 4 2 4 2 4 2 4 2 4 2 4 2 4 2 4 2 4 2 4 2 4 2 4 2 4 2 4 2
4 5 6 7 5 2 4 5 6 7 5 7 5 6 2 4 5 6 7 5 6 5 7 5 6 2 4 5 6 7 5 7 5 6
4 6 6 7 8 9 10 11 11 6 5 7 8 10 11 11 6 5 7 8 10 11 11 6 5 7 8 10 11 11 6 5 7 8 10 11
4 5 7 6 6 7 6 5 7 6 7 6 5 7 6 7 6 5 7 6 7 6 5 7 6 7 6 5 7 6 7 6 5 7
4 5 4 5 4 2 4 2 4 2 4 2 4 2 4 2 4 2 4 2 4 2 4 2 4 2 4 2 4 2 4 2 4 6
4 5 6 7 8 8 6 7 7 8 8 6 5 8 9 7 7 8 6 7 7 8 8 6 5 8 9 7 7 8 6 5 8 9
4 5 6 7 8 6 7 6 6 5 8 7 6 6 5 8 7 6 6 5 8 7 6 6 5 8 7 6 6 7 8 6 7 8
4 6 6 9 10 10 11 11 6 6 8 10 10 10 11 6 6 8 10 9 10 11 6 6 8 10 9 10 11 6 6 6 8 11
4 5 6 7 8 7 9 5 7 9 8 7 9 5 7 9 8 7 9 5 7 9 8 7 9 5 7 9 8 7 9 5 7 5
4 8 8 6 7 8 6 7 8 6 7 8 6 7 8 6 7 8 6 7 8 6 7 8 6 7 8 6 7 8 6 7 8 10
4 6 9 7 8 10 8 6 9 7 8 10 8 6 9 7 8 10 8 6 9 9 6 10 8 9 6 10 7 8 10 6 9 8
4 5 8 6 8 10 23 25 14 6 16 28 12 10 23 25 26 28 17 23 10 22 28 17 23 25 14 6 28 10 23 25 26 28
4 6 2 4 6 5 2 4 2 4 2 4 2 4 2 4 2 4 2 4 2 4 2 4 2 4 2 4 2 4 2 4 2 4
4 14 6 9 8 9 14 12 13 15 5 13 12 13 15 14 11 12 13 15 14 13 12 13 15 5 11 12 13 13 15 5 13 15
4 6 4 7 7 7 5 4 7 7 7 7 7 5 4 7 7 7 7 7 7 5 4 7 7 7 5 4 7 7 7 7 7 8
4 5 13 10 11 8 12 13 10 12 11 12 6 14 5 15 16 8 12 13 10 12 11 12 5 15 16 8 12 6 14 5 15 16
4 5 2 4 5 5 6 4 5 5 6 4 5 5 6 4 5 5 6 4 5 5 6 4 5 5 6 4 5 5 6 5 6 5
4 5 7 6 9 10 11 7 11 7 9 10 11 7 9 11 7 9 10 11 7 7 9 8 11 7 7 9 8 11 7 9 11 12
4 5 7 8 9 7 8 9 7 8 9 7 8 9 7 8 9 7 8 9 7 8 9 7 8 9 7 8 9 7 8 9 7 8
4 5 7 8 9 26 17 18 22 12 21 26 25 25 20 26 11 17 18 19 26 25 25 23 20 26 25 25 24 11 12 21 26 25
4 5 5 7 7 6 6 7 6 6 7 6 6 7 6 6 7 6 6 7 6 6 7 6 6 7 6 6 7 6 6 7 6 6
4 5 9 11 10 9 7 8 8 8 7 9 7 11 8 8 7 9 7 11 8 8 7 9 7 11 8 8 7 9 7 11 8 8
4 5 6 7 8 9 10 6 15 8 12 11 15 7 9 10 15 6 7 15 9 12 11 15 7 9 10 15 6 7 15 9 12 11
4 5 6 10 11 9 13 13 8 11 9 13 13 13 5 6 8 11 9 13 13 8 7 9 13 13 13 5 6 8 11 9 13 13
4 5 7 4 5 6 6 5 6 6 5 6 5 6 6 5 6 5 6 6 5 6 5 6 5 6 6 5 6 5 6 5 6 5
4 5 7 6 6 6 7 5 6 6 6 7 5 6 6 6 7 5 6 6 6 7 5 6 6 7 5 6 6 7 5 6 6 7
4 2 4 6 5 6 5 2 4 6 5 6 5 2 4 6 5 6 2 4 6 5 6 5 2 4 6 5 6 2 4 6 5 6 5
4 5 7 7 5 10 12 10 12 7 5 10 12 12 9 10 12 7 5 12 10 12 12 5 12 12 9 10 12 7 9 10 12 12
4 5 6 7 5 8 4 5 6 7 5 6 8 4 5 6 5 7 5 6 8 4 5 6 5 7 5 6 8 4 5 6 5 7 5 6
4 5 6 4 5 5 6 4 5 5 6 4 5 5 6 4 5 5 6 4 5 5 6 4 5 5 6 4 5 5 6 4 5 5 6 4 5 5 6 4 5 5 6 4 5 5 6 4 5 5 6 4 5 5 6 4 5 5 6 4 5 5 6 4 5 5 6 4 5 5 6 4 5 5 6 4 5 5 6 4
4 8 9 11 11 13 13 13 8 5 11 11 11 13 9 8 5 11 11 11 13 9 8 5 11 11 11 13 9 8 5 11 11 13
4 5 6 6 2 4 5 6 6 6 6 5 6 6 6 5 6 6 6 5 6 6 6 5 6 6 6 5 6 6 6 5 6 6
4 8 6 7 9 5 9 5 5 7 5 9 5 7 9 5 5 7 5 9 5 7 5 9 5 7 5 9 5 7 5 9 5 9
4 5 4 5 2 4 2 4 2 4 2 4 2 4 2 4 2 4 2 4 2 4 2 4 2 4 2 4 2 4 2 4 2 4
4 6 5 4 6 5 4 2 4 2 4 2 4 2 4 2 4 2 4 2 4 2 4 2 4 2 4 2 4 2 4 2 4 2 4
4 5 12 13 14 14 8 8 13 14 14 8 8 13 14 14 8 6 13 14 14 8 6 13 14 14 8 8 13 14 14 8 8 10
4 8 7 7 7 8 8 8 8 7 8 8 8 7 8 8 8 7 8 8 8 8 7 8 8 8 8 7 8 8 8 8 8 8
4 5 8 7 11 6 7 11 5 10 11 9 10 11 9 10 11 9 10 11 9 10 11 9 10 11 9 10 11 9 10 11 9 10
4 7 6 7 7 8 4 5 6 7 7 8 4 5 6 7 7 8 4 5 6 7 7 8 4 5 6 7 7 8 4 5 6 7 7 8 4 5 6 7 7 8 4 5 6 7 7 8 4 5 6 7 7 8 4 5 6 7 7 8 4 5 6 7 7 8 4 5 6 7 7 8 4 5 6 7 7 8 4 7
