4 5 6 4 5 6 4 5 6 5 6 4 5 6 5 6 5 6 5 6 5 6 5 6 5 6 5 6 5 6 5 6 5 7 7
4 17 12 7 9 19 5 20 22 15 19 22 17 20 22 22 19 22 20 22 22 19 22 5 20 22 22 19 22 20 22 22 19 22
4 5 6 7 8 5 8 5 6 7 8 5 8 5 6 7 8 5 8 5 6 7 8 5 8 5 6 7 8 5 8 5 6 7 8
4 5 6 4 5 6 5 6 4 5 6 5 6 4 5 6 5 6 5 6 5 6 5 6 5 6 5 6 5 6 5 6 5 6 5 6 5 6 5 6 5 6 5 6 5 6 5 6 5 6 5 6 5 6 5 6 5 6 5 6 5 6 5 6 5 6 5 6 5 6 5 6 5 6 5 6 5 6 5 6
4 5 9 7 6 10 10 11 7 6 10 7 9 10 7 6 10 7 6 10 7 6 10 7 6 10 7 6 10 7 6 10 7 8
4 5 12 11 7 8 9 12 11 6 13 9 9 11 12 11 5 13 9 9 11 12 11 5 13 9 9 11 12 11 5 13 9 9
4 5 5 7 8 10 11 6 5 8 10 11 6 5 7 8 10 11 5 8 11 6 5 8 10 11 6 11 9 8 10 11 6 9 8 10 11
4 13 11 6 12 12 5 10 9 8 9 12 5 8 9 9 8 9 12 12 11 8 9 8 9 12 7 8 9 9 8 9 12 12
4 11 7 10 12 13 5 12 13 11 13 11 12 13 11 13 11 12 13 11 13 11 12 13 11 13 11 12 13 11 13 11 12 13
4 5 6 7 8 7 8 9 6 9 7 8 5 6 7 8 9 5 6 7 8 9 5 6 7 8 9 5 6 7 8 9 9 6
4 5 6 8 7 6 7 9 10 9 11 9 9 11 9 7 6 7 9 10 11 9 9 7 6 7 8 9 9 10 11 9 9 11
4 5 6 7 7 6 8 9 8 7 6 8 9 8 7 6 7 6 8 9 8 7 6 7 6 8 9 8 7 6 7 6 8 9
4 5 6 7 8 8 5 6 7 7 8 8 5 6 7 7 8 5 6 7 8 5 6 7 8 5 6 7 8 5 6 7 7 8
4 5 8 5 7 8 10 11 12 1 4 5 5 7 8 11 7 8 13 11 12 13 11 13 11 12 13 11 13 11 12 13 11 13
4 5 2 4 5 4 2 4 5 4 2 4 2 4 5 4 2 4 2 4 5 4 2 4 5 4 2 4 5 4 2 4 5 4 2 4 5 4 2 4 5 4 2 4 5 4 2 4 5 4 2 4 5 4 2 4 5 4 2 4 5 4 2 4 5 4 2 4 5 4 2 4 5 4 2 4 5 4 2 4
4 5 15 16 8 7 8 14 15 16 19 10 12 14 15 16 17 10 12 14 15 16 19 12 14 19 10 13 14 15 16 17 10 12 14 19
4 6 9 8 10 10 11 2 2 4 8 9 6 10 10 2 4 7 4 8 9 6 7 4 7 4 8 9 6 7 4 8 9 6 10 11
4 20 7 8 9 15 11 17 7 8 6 18 19 12 11 17 7 8 6 18 19 11 12 7 8 17 18 19 16 17 7 8 6 18
4 6 7 8 1 4 6 5 6 7 5 6 7 5 6 7 5 6 7 5 6 7 5 6 7 5 6 7 5 6 7 5 6 7 8
4 6 6 7 8 6 5 6 6 7 8 5 6 6 6 7 8 5 6 6 6 7 8 5 6 6 6 7 8 5 6 6 5 7 8
4 5 6 1 4 5 7 5 6 7 5 7 5 6 7 5 6 7 5 6 7 5 6 7 5 6 7 5 6 7 5 6 7 5 6
4 5 5 13 8 10 10 9 8 10 10 9 11 12 13 8 10 10 9 8 10 9 11 12 13 8 10 10 9 8 10 9 11 12 13 8 10 10 9 8 10 9 11 12 13 8 10 10 9 8 10 9 11 12 13 8 10 10 9 8 10 9 11 12 13 8 10 10 9 8 10 9 11 12 13 8 10 10 9 8
4 5 6 4 5 6 5 6 4 5 6 5 6 4 5 5 6 4 5 6 5 6 5 6 5 6 5 6 5 6 5 6 5 6 5 6 5 6 5 6 5 6 5 6 5 6 5 6 5 6 5 6 5 6 5 6 5 6 5 6 5 6 5 6 5 6 5 6 5 6 5 6 5 6 5 6 5 6 5 6
4 5 6 7 8 15 9 10 6 19 21 8 22 23 24 13 13 16 15 10 11 7 21 24 22 23 24 13 15 14 24 13 10 11 7 8 14
4 5 6 7 12 12 9 7 12 5 12 5 7 12 12 9 7 12 5 12 5 7 12 12 9 7 12 5 12 5 7 12 12 5
4 5 6 10 7 10 7 10 7 10 7 10 7 10 7 10 7 10 7 10 7 10 7 10 7 10 7 10 7 10 7 10 7 5
4 8 11 9 8 9 11 8 9 11 8 9 11 8 9 11 8 9 11 8 9 11 8 9 11 8 9 8 11 9 8 11 9 8
4 5 2 4 5 5 6 2 4 5 5 5 6 2 4 5 5 5 6 2 4 5 5 5 6 2 4 5 5 5 6 2 4 5 5 5 6 7
4 8 13 7 12 10 6 13 12 18 19 18 14 5 19 5 14 10 16 11 19 5 14 5 19 5 14 10 16 11 19 5 14 8 19
4 5 7 5 7 5 5 1 4 5 5 7 5 7 8 7 5 5 7 5 5 7 5 7 5 5 5 7 5 7 5 7 5 5
4 5 8 6 5 8 1 4 7 7 8 9 5 8 6 7 8 7 7 7 8 1 4 7 7 8 9 5 8 6 7 8 5 8
4 5 6 7 2 4 5 5 6 7 8 5 6 7 2 4 5 5 6 7 2 4 5 5 6 7 8 5 6 7 2 4 5 5 6 7 8
4 5 6 7 8 9 13 11 12 13 11 12 13 11 12 8 5 9 13 11 12 13 11 12 12 13 11 12 9 13 11 12 10 14
4 5 8 6 5 8 1 2 4 5 6 5 8 7 5 6 2 5 6 2 5 6 8 5 6 2 4 5 6 5 8 6 5 8
4 5 6 11 8 9 11 9 6 8 11 9 11 8 9 11 10 9 6 8 11 9 11 8 9 11 10 9 6 8 11 9 11 8 9
4 5 6 6 7 7 1 4 5 6 5 7 6 6 7 7 6 7 6 5 7 1 4 5 6 5 7 6 6 7 7 6 5 7
4 8 15 23 10 13 24 10 22 18 23 24 13 24 10 22 18 23 24 13 24 10 22 18 23 24 13 24 10 22 18 23 24 9
4 5 6 7 8 7 6 7 8 7 6 7 8 7 6 7 8 7 6 7 8 7 6 7 8 7 6 7 8 7 6 7 8 7
4 6 7 5 5 5 5 5 1 4 5 7 5 5 7 5 5 5 7 5 5 5 5 7 5 5 5 5 7 5 5 5 7 5
4 6 4 5 4 5 4 5 4 5 4 5 4 5 4 5 4 5 4 5 4 5 4 5 4 5 4 5 4 5 4 5 4 5 4 5 4 5 4 5 4 5 4 5 4 5 4 5 4 5 4 5 4 5 4 5 4 5 4 5 4 5 4 5 4 5 4 5 4 5 4 5 4 5 4 5 4 5 4 6
4 7 14 23 24 17 13 10 14 21 23 25 22 10 24 19 10 24 19 20 23 24 19 10 24 19 10 21 23 25 22 10 24 9
4 5 6 4 5 6 5 6 4 5 6 5 6 4 5 6 5 6 5 6 5 6 5 6 5 6 5 6 5 6 4 5 6 5 6 5 6 5 6 5 6 5 6 5 6 5 6 5 6 5 6 5 6 5 6 5 6 5 6 5 6 5 6 5 6 5 6 5 6 5 6 5 6 5 6 5 6 5 6 5
4 5 4 5 4 5 4 5 4 5 4 5 4 5 4 5 4 5 4 5 4 5 4 5 4 5 4 5 4 5 4 5 4 5 4 5 4 5 4 5 4 5 4 5 4 5 4 5 4 5 4 5 4 5 4 5 4 5 4 5 4 5 4 5 4 5 4 5 4 5 4 5 4 5 4 5 4 5 4 5
4 5 6 7 7 1 2 4 5 6 7 7 7 2 5 6 7 7 2 5 6 7 7 1 4 5 6 7 7 7 5 6 7 7
4 6 6 7 8 10 11 6 5 11 6 5 7 8 11 6 9 11 6 6 9 11 6 5 7 8 11 6 6 9 11 6 5 9 11
4 5 6 7 6 7 1 2 4 5 5 6 7 7 6 7 5 6 7 1 2 4 5 5 6 7 7 5 6 7 6 7 5 7
4 5 4 5 4 5 4 5 4 5 4 5 4 5 4 5 4 5 4 5 4 5 4 5 4 5 4 5 4 5 4 5 4 6
4 5 5 8 9 6 9 7 8 9 6 9 7 8 1 4 5 5 5 8 6 7 8 9 6 7 8 1 4 5 7 8 6 7 8 9
4 5 7 6 6 7 6 6 7 8 6 6 7 8 6 6 7 8 6 6 7 8 6 6 7 8 6 6 7 8 6 6 7 8
4 6 6 10 9 11 11 6 6 8 10 9 10 11 6 6 8 10 9 10 11 6 6 8 10 9 10 11 6 6 8 10 10 11
4 5 6 8 7 9 5 7 5 7 5 7 9 8 7 9 9 7 8 9 5 7 5 7 5 7 9 8 7 9 5 7 9 7
4 7 8 6 7 8 6 7 8 6 7 8 6 7 8 6 7 8 6 7 8 6 7 8 6 7 8 6 7 8 6 7 8 10
4 7 9 6 9 8 10 6 5 9 9 8 10 6 5 9 8 10 6 7 9 9 8 10 6 5 9 9 8 10 6 7 9 10
4 5 25 14 6 7 20 23 11 14 21 10 23 25 26 6 16 17 12 10 28 17 18 17 9 10 28 17 18 17 9 10 28 17 18 17 9 10 28
4 6 2 4 5 4 5 4 5 4 5 4 5 4 5 4 5 4 5 4 5 4 5 4 5 4 5 4 5 4 5 4 5 4 5 4 5 4 5 4 5 4 5 4 5 4 5 4 5 4 5 4 5 4 5 4 5 4 5 4 5 4 5 4 5 4 5 4 5 4 5 4 5 4 5 4 5 4 5 4
4 14 6 6 9 8 9 6 14 11 12 13 15 5 11 12 13 13 15 5 11 12 13 13 15 5 11 12 13 15 14 11 12 13
4 7 2 4 5 4 5 4 7 7 7 7 7 2 4 5 4 5 4 5 4 5 4 5 4 5 4 7 7 7 7 7 7 8
4 5 8 12 13 10 11 15 16 8 12 6 10 7 15 16 8 12 6 10 11 14 12 11 12 6 14 15 16 8 12 6 10 11
4 5 6 2 4 5 6 5 6 5 6 5 6 5 6 5 6 4 5 6 5 6 5 6 5 6 5 6 5 6 5 6 5 6 5 6 5 6 5 6 5 6 5 6 5 6 5 6 5 6 5 6 5 6 5 6 5 6 5 6 5 6 5 6 7
4 5 7 6 9 10 11 7 9 7 9 11 7 9 7 9 10 11 7 9 7 9 11 7 9 7 9 10 11 7 9 7 11 12
4 5 6 8 9 6 2 4 5 7 7 9 6 8 9 6 2 4 5 7 7 9 6 6 8 9 6 2 4 5 7 7 9 6 6 8 9
4 5 17 18 8 9 26 17 22 12 13 20 16 17 18 6 20 26 25 26 17 18 24 25 26 17 18 23 20 16 17 18 24 25 26
4 5 5 7 7 5 7 5 7 5 7 5 7 5 7 5 7 5 7 5 7 5 7 5 7 5 7 5 7 5 7 5 7 5
4 5 9 7 10 6 8 7 11 9 8 6 8 7 11 9 8 6 8 7 11 9 8 6 8 7 11 9 8 6 8 7 11 9
4 5 6 8 9 10 6 8 9 10 5 15 7 12 9 5 15 7 12 9 5 15 7 12 9 5 15 7 12 9 5 15 7 12 9
4 5 6 11 8 13 10 6 7 8 13 2 4 5 6 7 8 11 10 13 9 6 7 13 13 2 4 5 6 7 8 11 10 13
4 5 6 2 4 5 6 6 2 4 5 7 5 6 6 5 6 6 2 4 5 7 5 6 6 5 6 6 2 4 5 5 6 6 6 5 6 6
4 6 6 7 1 4 5 6 7 5 6 6 7 5 6 6 6 7 1 4 5 6 7 5 6 6 7 5 6 6 6 7 1 4 5 6 7 5 6 7
4 2 4 6 5 6 2 4 6 5 6 5 2 4 6 5 6 5 2 4 6 5 6 5 6 2 4 6 5 6 5 2 4 6 5 6 5
4 5 7 5 10 12 12 5 12 5 10 12 1 2 4 9 14 4 9 14 4 9 14 4 9 14 4 9 14 4 9 14 4 9 14 4 9 14 4 9 14 4 9 14 4 9 14 4 9 14 4 9 14 4 9 14 4 9 14 4 9 14 4 9 14 4 9 14 4 9 14 4 9 14 4 9 14 4 5 14
4 5 6 7 7 1 4 5 6 7 7 6 7 1 4 5 7 6 7 7 7 5 6 7 7 2 4 5 7 6 7 7 5 6 7
4 5 2 4 5 6 5 6 4 5 6 5 6 5 6 5 6 5 6 4 5 6 5 6 5 6 5 6 5 6 5 6 5 6 5 6 5 6 5 6 5 6 5 6 5 6 5 6 5 6 5 6 5 6 5 6 5 6 5 6 5 6 5 6 5 6 5 6 5 6 5 6 5 6 5 6 5 6 5 6
4 8 9 12 11 13 13 8 8 12 11 13 13 8 8 12 11 13 13 8 8 12 11 13 13 8 8 12 11 13 13 8 8 12 11 13
2 4 5 6 2 4 5 6 5 6 5 6 6 5 2 4 5 6 5 6 6 5 1 4 5 6 5 6 2 4 5 6 5 6 5 6
4 8 6 7 9 8 8 9 8 8 6 7 9 8 8 9 8 8 6 7 9 8 8 9 8 8 9 8 6 7 9 8 5 9
4 5 2 4 5 2 4 5 4 5 5 4 5 5 4 5 5 4 5 5 4 5 5 4 5 5 4 5 5 4 5 5 4 5 5 4 5 5 4 5 5 4 5 5 4 5 5 4 5 5 4 5 5 4 5 5 4 5 5 4 5 5 4 5 5 4 5 5 4 5 5 4 5 5 4 5 5 4 5 5
4 6 2 4 5 4 5 4 5 4 5 4 5 4 5 4 5 4 5 4 5 4 5 4 5 4 5 4 5 4 5 4 5 4 5 4 5 4 5 4 5 4 5 4 5 4 5 4 5 4 5 4 5 4 5 4 5 4 5 4 5 4 5 4 5 4 5 4 5 4 5 4 5 4 5 4 5 4 5 4
4 5 12 13 13 14 8 6 14 8 8 11 14 8 8 6 14 8 8 6 14 8 8 6 14 8 8 6 14 8 8 6 14 6
4 8 7 7 7 8 7 8 8 7 8 8 7 8 8 7 8 8 7 8 8 7 8 8 7 8 8 7 8 8 7 8 8 8
4 9 8 7 11 5 10 11 5 8 11 5 10 11 9 8 11 9 10 11 9 8 11 9 10 11 9 8 11 9 10 11 5 8 11
4 7 6 7 7 1 4 7 7 8 4 7 7 8 4 7 7 8 4 7 7 8 4 7 7 8 4 7 7 8 4 7 7 8 4 7 7 8 4 7 7 8 4 7 7 8 4 7 7 8 4 7 7 8 4 7 7 8 4 7 7 8 4 7 7 8 4 7 7 8 4 7 7 8 4 7 7 8 4 7
