4 5 6 4 5 6 4 5 6 5 6 5 6 5 6 5 6 5 6 5 6 5 6 5 6 5 6 5 6 5 6 5 6 5 7
4 17 14 7 9 21 22 17 20 22 22 22 19 22 17 20 22 22 19 22 22 17 20 22 22 19 22 22 17 20 22 22 19 22
4 5 5 7 6 8 5 7 6 8 8 5 7 6 8 8 5 7 6 8 5 7 6 8 8 5 7 6 8 5 7 6 7 8
4 5 6 4 5 6 5 6 4 5 6 5 6 5 6 5 6 5 6 5 6 5 6 5 6 5 6 5 6 5 6 5 6 5 6 5 6 5 6 5 6 5 6 5 6 5 6 5 6 5 6 5 6 5 6 5 6 5 6 5 6 5 6 5 6 5 6 5 6 5 6 5 6 5 6 5 6 5 6 5
4 5 8 7 8 10 10 11 7 9 9 10 10 11 7 8 6 10 10 11 7 9 9 10 10 11 7 8 6 10 10 11 7 8
4 5 12 11 8 9 11 12 6 13 9 11 6 13 7 8 9 11 12 11 5 13 5 7 8 9 11 12 11 5 13 7 8 9 11 12
4 9 6 7 8 10 11 5 8 10 11 5 8 10 11 5 7 8 10 11 9 8 10 11 5 8 10 11 5 8 10 11 9 8 10 11
4 7 11 6 12 12 10 9 8 9 10 12 12 7 8 9 9 8 9 8 9 9 8 9 8 9 9 8 9 8 9 9 8 9
4 5 7 10 12 13 5 12 13 11 7 10 7 11 13 11 12 13 11 7 10 7 5 12 13 11 7 10 5 12 13 11 7 10
4 5 6 7 8 9 9 7 8 5 6 7 8 9 9 7 6 9 7 8 9 9 7 6 9 7 8 9 9 7 6 9 7 8 5
4 5 6 8 7 6 10 11 9 10 11 9 10 11 9 10 11 9 10 11 9 10 11 9 10 11 9 10 11 9 10 11 9 11
4 5 6 7 7 6 8 9 5 8 9 8 7 6 7 6 8 9 5 8 9 8 7 6 1 4 5 5 6 8 7 6 7 6
4 5 6 7 8 1 2 4 5 6 7 7 6 7 7 6 7 7 8 5 6 7 7 8 1 4 5 6 7 7 7 6 7 8
4 11 8 10 7 8 11 7 13 11 11 7 8 10 11 12 13 11 11 13 11 7 8 11 7 13 11 12 13 11 11 12 10 13
4 5 4 5 4 7 2 4 6 4 5 4 7 2 4 6 4 7 2 4 5 4 7 2 4 6 4 7 2 4 5 4 7 2 4 5 4 7
4 5 15 16 8 7 8 9 10 14 15 16 19 13 13 14 19 5 10 12 11 13 19 15 16 19 13 14 10 12 14 19 5 12 11 13 19
4 8 9 6 10 11 9 8 9 10 11 8 9 10 11 9 8 9 10 11 9 8 9 10 11 9 8 9 10 11 9 8 10 11
4 20 14 9 19 11 12 7 8 12 9 19 6 7 8 12 9 19 6 7 8 12 9 19 6 7 8 12 9 19 6 7 8 12 9 19 6
4 6 7 8 8 8 1 4 6 6 5 6 7 5 6 7 5 6 7 5 6 8 8 7 6 7 8 8 1 4 6 6 7 5 6 7 8 8
4 6 6 7 8 5 5 1 4 6 6 7 8 5 5 5 7 8 5 5 1 4 6 6 7 8 5 6 5 7 8 5 5 5
4 5 6 1 4 5 7 5 6 7 5 6 7 5 6 7 5 6 7 5 6 7 5 6 7 5 6 7 5 6 7 5 6 7 5 6
4 12 8 9 11 9 8 13 8 10 9 11 9 8 13 8 10 9 11 9 8 13 8 10 9 11 9 8 13 8 10 9 11 9 8 13 8 10 9 11 9 8 13 8 10 9 11 9 8 13 8 10 9 11 9 8 13 8 10 9 11 9 8 13 8 10 9 11 9 8 13 8 10 9 11 9 8 13 8 10
4 5 6 4 5 6 5 6 4 5 6 5 6 5 6 5 6 5 6 5 6 5 6 5 6 5 6 5 6 5 6 5 6 5 6 5 6 5 6 5 6 5 6 5 6 5 6 5 6 5 6 5 6 5 6 5 6 5 6 5 6 5 6 5 6 5 6 5 6 5 6 5 6 5 6 5 6 5 6 5
4 5 18 12 8 9 17 20 11 12 21 8 22 23 24 13 13 16 15 20 11 19 13 16 15 14 17 18 19 10 20 21 24 13 22 23 24
4 9 6 7 12 12 9 9 5 7 12 12 9 5 7 12 12 9 5 7 12 12 9 5 7 12 12 9 5 7 12 12 9 5
4 5 6 10 7 10 9 7 10 6 7 10 7 10 7 9 5 10 6 7 10 7 10 9 7 10 7 9 5 10 6 7 10 7
4 5 8 9 11 8 9 11 8 9 11 8 9 11 8 9 11 8 9 11 8 9 11 8 9 11 8 9 11 8 9 11 8 9
4 5 2 4 5 5 2 4 5 5 2 4 5 5 5 6 2 4 5 5 5 5 6 2 4 5 5 5 2 4 5 5 5 6 7
4 18 6 7 7 12 15 12 18 19 16 11 19 18 19 16 12 10 16 18 19 18 19 16 12 10 16 11 19 18 19 16 12 10
4 8 7 7 5 5 1 4 5 5 7 5 7 5 7 8 7 8 8 7 5 5 1 4 5 5 7 5 7 5 7 8 7 8
4 5 8 6 5 8 1 4 7 7 8 6 5 8 5 8 1 4 7 7 8 6 5 8 5 8 1 4 7 7 8 6 5 8
4 5 6 7 1 4 5 5 6 7 8 5 6 7 1 4 5 2 4 5 5 6 7 8 5 6 7 1 4 5 5 6 7 8
4 5 6 7 8 5 9 13 11 12 13 14 12 12 5 7 8 1 4 5 6 7 8 5 6 7 8 5 9 13 11 12 13 14
4 5 8 6 5 8 1 1 4 5 6 5 8 1 4 5 6 5 8 7 5 6 8 5 6 1 4 5 8 5 6 8 5 6
4 5 6 10 11 8 9 11 6 9 8 11 11 9 6 8 11 9 11 6 9 8 11 11 9 6 8 11 9 11 6 9 8 11
4 6 5 7 6 7 6 7 6 7 5 7 1 4 5 5 7 6 6 7 5 7 6 6 7 7 6 7 5 7 6 6 7 7
4 8 18 23 10 22 24 10 22 15 21 23 25 22 21 21 22 18 24 10 22 15 21 23 25 22 21 21 22 15 21 23 25 19
4 5 6 7 8 1 4 5 6 7 8 7 6 7 8 7 6 7 8 1 4 5 6 5 8 7 6 7 8 7 6 7 8 7
4 7 6 7 5 1 4 5 5 7 5 5 7 5 5 6 7 5 5 5 1 4 5 7 5 5 7 5 5 7 5 5 5 1 4 5 7 5 5 7 5 5
4 6 4 5 4 5 4 5 4 5 4 5 4 5 4 5 4 5 4 5 4 5 4 5 4 5 4 5 4 5 4 5 4 5 4 5 4 5 4 5 4 5 4 5 4 5 4 5 4 5 4 5 4 5 4 5 4 5 4 5 4 5 4 5 4 5 4 5 4 5 4 5 4 5 4 5 4 5 4 6
4 7 14 23 24 17 22 10 15 21 23 25 22 10 24 19 14 14 23 25 13 10 24 19 20 20 23 25 22 10 24 9 20 20 23 25 22 10
4 5 6 4 5 6 5 6 4 5 6 5 6 5 6 5 6 5 6 5 6 5 6 5 6 5 6 5 6 5 6 5 6 5 6 5 6 5 6 5 6 5 6 5 6 5 6 5 6 5 6 5 6 5 6 5 6 5 6 5 6 5 6 5 6 5 6 5 6 5 6 5 6 5 6 5 6 5 6 5
4 5 4 5 4 5 4 5 4 5 4 5 4 5 4 5 4 5 4 5 4 5 4 5 4 5 4 5 4 5 4 5 4 5 4 5 4 5 4 5 4 5 4 5 4 5 4 5 4 5 4 5 4 5 4 5 4 5 4 5 4 5 4 5 4 5 4 5 4 5 4 5 4 5 4 5 4 5 4 5
4 5 6 7 6 7 1 4 5 7 6 7 7 6 7 5 1 4 5 7 6 7 7 5 6 7 7 5 1 4 5 7 6 7 7 5
4 6 6 7 8 10 9 11 6 5 7 8 10 9 11 6 5 7 8 10 9 11 6 5 7 8 10 9 11 6 6 7 8 10 9 11
4 5 6 7 1 1 4 5 5 6 7 1 4 5 6 7 5 6 7 1 4 5 6 7 5 6 7 1 4 5 6 7 5 6 7
4 5 4 5 4 5 4 5 4 5 4 5 4 5 4 5 4 5 4 5 4 5 4 5 4 5 4 5 4 5 4 5 4 6
4 7 6 8 9 7 9 7 8 9 7 7 8 9 7 7 8 9 7 7 8 9 7 7 8 9 7 7 8 9 7 7 8 9
4 5 6 7 6 7 6 7 6 5 8 7 6 6 7 6 5 8 7 6 6 7 6 5 8 7 6 6 7 6 5 8 7 6
4 6 6 10 9 11 11 8 10 9 10 11 6 6 8 10 9 10 11 8 10 9 11 11 6 8 10 9 11 8 10 9 10 11
4 5 6 8 7 5 7 5 7 9 7 8 5 7 9 7 8 5 7 5 7 9 7 8 5 7 5 7 9 7 8 5 7 5
4 7 8 6 7 8 6 7 8 8 6 7 8 8 6 7 8 6 7 8 6 7 8 6 7 8 6 7 8 6 7 8 8 10
4 5 6 9 9 6 8 5 9 6 7 9 8 6 7 9 5 8 6 7 9 9 8 6 7 9 5 10 8 6 7 9 7 10
4 5 25 14 6 7 20 21 10 23 25 26 6 16 28 17 23 10 28 17 18 17 20 21 10 28 17 23 25 14 6 28 17 18 10 22 17 23 25 14 6 28
4 6 1 4 6 5 4 5 4 5 4 5 4 5 4 5 4 5 4 5 4 5 4 5 4 5 4 5 4 5 4 5 4 5 4 5 4 5 4 5 4 5 4 5 4 5 4 5 4 5 4 5 4 5 4 5 4 5 4 5 4 5 4 5 4 5 4 5 4 5 4 5 4 5 4 5 4 5 4 5
4 5 6 7 8 9 7 5 12 13 15 5 11 12 13 15 5 11 12 13 15 5 11 12 13 15 5 11 12 13 15 5 11 12
4 7 2 4 7 5 4 7 7 5 4 7 7 7 5 4 7 7 7 7 1 4 7 5 4 7 5 4 7 5 4 7 7 7 7 8
4 5 13 10 8 12 11 12 6 7 15 16 5 8 12 6 10 7 15 16 5 8 12 6 10 7 15 16 5 8 12 6 10 7 15 16
4 5 1 4 5 6 5 2 4 5 6 5 6 5 6 5 6 5 6 5 6 5 6 5 6 5 6 5 6 5 6 5 6 5 6 5 6 5 6 5 6 5 6 5 6 5 6 5 6 5 6 5 6 5 6 5 6 5 6 5 6 5 6 5 6 5 6 5 6 5 6 5 6 5 6 5 6 5 6 5
4 5 8 6 9 7 11 12 7 9 11 7 9 7 9 8 11 7 9 7 9 11 7 9 7 9 8 11 7 9 7 9 7 12
4 5 7 9 6 8 9 6 1 4 5 7 7 9 7 8 9 6 5 6 8 9 6 1 4 5 7 7 9 6 8 9 6 5
4 5 17 18 7 8 9 10 22 12 13 20 16 17 18 26 25 26 17 18 12 13 20 15 16 17 18 26 25 26 17 18 24 25 26
4 6 6 7 7 6 7 6 7 6 7 6 7 6 7 6 7 6 7 6 7 6 7 6 7 6 7 6 7 6 7 6 7 6
4 5 9 8 10 7 6 8 6 8 7 11 9 5 8 6 8 7 11 9 8 6 8 7 11 9 5 8 6 8 7 11 9 7
4 11 6 8 9 10 9 10 5 15 7 11 15 12 9 5 15 7 11 15 10 9 10 5 15 7 11 15 10 9 12 5 15 7
4 5 6 11 10 13 9 6 9 11 13 1 4 5 6 7 10 11 10 6 9 11 10 13 9 6 7 10 13 1 4 5 6 11 10 9 11 10 13
4 5 6 1 4 5 6 6 6 2 4 5 5 6 6 2 4 5 5 6 6 5 6 6 2 4 5 5 6 6 5 6 6 5 6
4 6 6 7 5 1 4 5 6 7 7 5 6 6 6 7 5 1 4 5 6 7 5 6 7 5 6 6 7 5 1 4 5 6 7 5 6 7 5
4 6 5 1 4 6 5 2 4 6 5 6 5 6 2 4 6 5 6 5 6 2 4 6 5 6 5 6 2 4 6 5 6 5 6 5
4 5 7 9 10 12 12 5 10 12 5 12 12 10 7 5 10 12 12 5 10 12 9 12 12 10 7 5 10 12 12 9 10 12
4 5 6 7 6 7 7 1 4 5 8 5 7 6 7 7 7 6 7 7 5 1 4 5 8 5 7 6 7 7 7 6 7 7
4 5 6 4 5 6 4 5 6 5 6 5 6 5 6 5 6 5 6 5 6 5 6 5 6 5 6 5 6 5 6 5 6 5 6 5 6 5 6 5 6 5 6 5 6 5 6 5 6 5 6 5 6 5 6 5 6 5 6 5 6 5 6 5 6 5 6 5 6 5 6 5 6 5 6 5 6 5 6 5
4 8 5 12 12 13 13 8 8 12 12 13 13 8 8 12 12 13 13 8 8 12 12 13 13 8 8 12 12 13 13 8 8 12 12 13
4 5 6 1 4 5 6 6 5 1 4 5 6 5 6 6 5 1 4 5 6 5 6 6 5 6 6 5 1 4 5 6 5 6
4 8 6 7 9 8 9 8 7 8 9 1 2 4 5 6 7 8 9 8 7 8 9 8 6 7 8 9 8 1 4 5 6 7 8 9
4 5 4 5 5 2 4 5 2 4 2 4 2 4 2 4 2 4 2 4 2 4 2 4 2 4 2 4 2 4 2 4 2 4 2 4 2 4 2 4 2 4 2 4 2 4 2 4 2 4 2 4 2 4 2 4 2 4 2 4 2 4 2 4 2 4 2 4 2 4 2 4 2 4 2 4 2 4 2 4
4 6 6 7 1 4 5 4 5 4 2 4 5 4 2 4 5 4 2 4 5 4 2 4 5 4 2 4 5 4 2 4 5 4 2 4 5 4 2 4 5 4 2 4 5 4 2 4 5 4 2 4 5 4 2 4 5 4 2 4 5 4 2 4 5 4 2 4 5 4 2 4 5 4 2 4 5 4 2 4
4 5 12 14 8 8 14 14 11 8 11 14 14 8 8 8 14 14 8 8 8 14 14 6 8 8 14 14 6 8 8 14 14 6
4 8 5 7 1 4 7 6 7 7 8 7 8 8 7 8 1 4 7 6 4 7 5 7 7 8 8 8 8 8 8 8 8 1 4 8 6 4 7 6 4 7 6 7 7 8 8 8 8 8
4 5 8 6 11 5 10 7 11 9 10 11 9 10 11 9 6 11 9 10 11 9 6 11 9 10 11 9 6 11 9 10 11 5
4 7 6 5 5 1 4 7 7 8 4 7 7 8 4 7 7 8 4 7 7 8 4 7 7 8 4 7 7 8 4 7 7 8 4 7 7 8 4 7 7 8 4 7 7 8 4 7 7 8 4 7 7 8 4 7 7 8 4 7 7 8 4 7 7 8 4 7 7 8 4 7 7 8 4 7 7 8 4 7
