4 5 2 4 5 6 7 5 6 5 6 2 4 5 5 6 7 5 6 5 6 7 5 6 5 6 5 6 5 1 4 5 7 7
4 17 14 7 9 21 22 5 20 22 22 5 20 22 22 5 20 22 22 5 20 22 22 5 20 22 22 5 20 22 22 5 20 22
4 5 5 7 7 8 5 6 7 8 8 5 6 7 8 8 5 6 7 8 8 5 7 7 8 8 5 7 6 8 8 5 7 7 8
4 5 1 4 5 6 2 4 5 6 5 6 5 6 5 6 5 6 5 6 5 6 5 6 5 6 5 6 5 6 5 6 5 6
4 5 5 7 9 8 10 7 9 6 10 11 7 9 6 7 9 6 7 8 10 11 7 9 6 7 9 6 7 9 10 7 9 6
4 6 12 7 8 9 11 12 9 13 9 11 6 5 13 7 8 9 11 12 6 13 9 11 11 12 9 5 13 9 11 6 13 9
4 5 6 7 8 10 11 9 8 10 11 5 5 8 10 11 9 5 8 10 11 9 5 8 10 11 9 5 8 10 11 9 9 8 10 11
4 7 11 6 12 12 7 8 9 10 9 8 9 11 8 9 9 8 9 8 9 10 12 7 8 9 8 9 10 12 7 8 9 8
4 11 7 10 12 13 5 12 13 11 13 5 12 13 11 7 10 11 13 11 12 13 11 10 7 11 13 11 12 13 11 10 7 11
4 9 8 6 7 8 9 7 8 6 9 7 8 9 9 7 8 5 6 9 7 8 9 9 7 8 5 6 9 7 8 9 5 7 8
4 5 6 8 7 9 10 11 9 9 10 11 6 7 9 10 11 9 6 9 10 11 9 7 6 7 9 10 11 9 6 9 10 11
4 5 6 7 6 7 6 8 9 5 8 9 5 8 9 8 6 7 6 8 9 5 8 9 8 7 6 7 6 8 9 5 8 9
4 5 6 7 8 8 1 5 6 7 7 8 5 6 7 8 1 1 4 5 6 7 6 7 8 5 6 7 8 7 8 1 5 6 7 8
4 5 8 10 11 7 13 11 11 12 13 11 10 11 13 11 11 13 11 7 8 11 7 13 11 11 13 11 5 12 13 11 5 13
4 2 4 2 4 2 4 2 4 2 4 2 4 2 4 2 4 2 4 2 4 2 4 2 4 2 4 2 4 2 4 2 4 2 4 2 4 2 4 2 4 2 4 2 4 2 4 2 4 2 4 2 4 2 4 2 4 2 4 2 4 2 4 2 4 2 4 2 4 2 4 2 4 2 4 2 4 2 4 2
4 5 10 14 7 15 16 19 12 12 14 15 16 19 13 13 14 15 16 19 13 13 14 15 16 19 13 13 14 15 16 19 13 13 19
4 8 9 10 10 11 8 9 10 10 11 8 9 10 10 11 8 9 10 10 11 8 9 10 10 11 8 9 10 10 11 8 9 11
4 6 14 9 11 12 13 8 12 18 19 6 20 7 8 12 18 19 6 13 8 12 18 19 6 13 8 12 18 19 6 13 8 12 18 19 6
4 6 7 7 8 8 8 1 4 6 6 5 6 7 5 6 8 8 7 5 6 8 8 7 8 8 1 4 6 6 5 6 7 5 6 8 8
4 6 6 7 8 5 5 5 7 8 5 5 5 7 8 5 5 5 7 8 5 5 5 7 8 5 5 5 7 8 5 5 5 7 8
4 5 6 1 4 5 6 7 5 6 2 4 5 5 7 5 6 7 5 6 7 5 6 7 5 6 7 5 6 7 5 6 7 5 6
4 12 11 12 13 8 10 10 12 13 8 10 10 9 11 12 13 8 10 10 9 8 10 9 11 12 13 8 10 10 9 8 10 9 11 12 13 8 9
4 5 1 4 5 2 4 5 6 5 6 5 6 5 2 4 5 5 6 5 6 5 6 5 6 5 6 5 6 5 6 5 6 5 6 5 6 5 6 5 6 5 6 5 6 5 6
4 5 11 7 9 17 21 15 16 15 14 18 7 9 17 21 15 16 22 23 15 9 17 18 19 13 16 15 14 17 6 7 9 17 21 14 22 23 24
4 5 6 7 12 12 9 7 5 12 5 9 7 12 9 9 7 12 9 9 7 12 9 9 7 12 9 9 7 12 9 9 7 12 5
4 5 6 10 7 10 10 7 10 7 10 7 10 7 10 7 10 7 10 7 10 7 10 7 10 7 10 7 10 7 10 7 10 7
4 8 9 11 9 8 9 8 11 9 8 9 8 11 9 8 9 8 11 9 8 9 8 11 9 8 9 8 11 9 8 11 9 8
4 5 6 6 7 7 5 6 1 4 5 5 2 4 5 5 2 4 5 5 2 4 5 5 2 4 5 5 2 4 5 5 5 6 6 7
4 5 6 7 7 14 10 16 11 19 11 14 5 19 11 14 8 19 11 14 10 16 11 19 11 14 5 19 11 14 5 19 18 14
4 8 7 8 8 5 1 4 5 5 5 7 5 7 8 5 5 5 5 7 8 8 5 1 4 5 5 6 4 5 5 6 4 5 5 6 4 5 5 6 4 5 5 6 4 5 5 6 4 5 5 6 4 5 5 6 4 5 5 6 4 5 5 6 4 5 5 6 4 5 5 6 4 5 5 6 4 5 5 6
4 5 8 6 5 8 1 4 7 5 8 9 7 6 5 8 9 7 6 5 8 7 8 7 6 5 8 7 1 4 7 6 5 8 9 7 6 5 8 7
4 5 6 7 7 8 5 6 7 1 4 5 2 4 5 5 6 7 7 8 5 6 7 1 4 5 2 4 5 6 5 7 7 8
4 5 6 7 8 9 13 11 12 13 11 12 10 14 12 10 14 12 10 9 14 12 13 11 12 8 5 12 13 9 14 12 10 14
4 8 6 5 6 8 1 1 4 5 6 8 6 8 5 6 8 5 6 8 5 6 8 1 1 4 5 6 8 5 6 8 5 6
4 5 6 8 11 9 11 9 6 8 11 9 11 9 6 8 11 9 11 9 6 10 11 8 9 11 9 6 8 11 9 11 9 8
4 6 5 7 7 6 7 6 7 6 7 5 7 6 7 6 7 6 7 5 7 6 7 6 7 6 7 5 7 6 7 6 7 7
4 8 15 23 10 9 24 10 26 20 8 25 22 24 21 13 18 23 25 22 24 21 13 18 23 25 22 24 21 13 18 23 25 19
4 5 6 7 8 1 4 5 6 7 8 1 4 5 6 7 8 2 4 5 6 7 8 2 4 5 6 7 8 2 4 5 6 7 8 5 6 7 8
4 7 6 7 5 1 4 5 5 7 5 5 7 5 5 5 6 5 6 6 7 7 5 5 5 5 6 7 5 5 5 5 7 5
4 2 4 2 4 2 4 2 4 2 4 2 4 2 4 2 4 2 4 2 4 2 4 2 4 2 4 2 4 2 4 2 4 2 4 2 4 2 4 2 4 2 4 2 4 2 4 2 4 2 4 2 4 2 4 2 4 2 4 2 4 2 4 2 4 2 4 2 4 2 4 2 4 2 4 2 4 2 4 2
4 7 20 23 24 17 22 10 8 25 22 14 24 9 10 7 25 22 14 23 24 25 13 10 19 14 24 23 25 13 10 9 24 18 23 25 13
4 5 1 4 5 6 2 4 5 6 5 6 5 6 5 6 5 6 5 6 5 6 5 6 5 6 5 6 5 6 5 6 5 6
4 2 4 2 4 2 4 2 4 2 4 2 4 2 4 2 4 2 4 2 4 2 4 2 4 2 4 2 4 2 4 2 4 2 4 2 4 2 4 2 4 2 4 2 4 2 4 2 4 2 4 2 4 2 4 2 4 2 4 2 4 2 4 2 4 2 4 2 4 2 4 2 4 2 4 2 4 2 4 2
4 5 6 7 6 7 1 5 6 7 6 7 7 1 2 4 5 7 6 7 7 6 7 7 6 7 7 6 7 7 6 7 1 5
4 6 5 7 8 10 9 11 6 5 7 8 10 9 11 6 5 7 8 10 9 11 6 5 7 8 10 9 11 6 6 7 8 10 9 11
4 5 6 7 1 5 1 4 5 6 7 7 6 5 7 6 7 6 7 1 5 2 4 5 5 6 7 6 7 5 6 7 6 7
4 5 4 5 2 4 2 4 2 4 2 4 2 4 2 4 2 4 2 4 2 4 2 4 2 4 2 4 2 4 2 4 2 4 2 4 2 4 2 4 2 4 2 4 2 4 2 4 2 4 2 4 2 4 2 4 2 4 2 4 2 4 2 4 2 4 2 4 2 4 2 4 2 4 2 4 2 4 2 4
4 7 6 8 9 7 7 9 7 9 7 7 8 9 6 7 9 7 7 8 9 7 5 9 7 5 8 9 6 7 9 7 8 9
4 5 7 8 6 7 8 6 7 1 4 5 5 8 7 8 6 7 6 6 7 8 6 7 1 4 5 5 6 7 8 6 7 8
4 6 6 8 11 10 9 10 11 6 8 10 9 10 11 6 8 10 9 10 11 6 8 10 9 10 11 6 8 10 9 10 11 11
4 8 6 9 7 8 7 5 7 5 8 7 9 7 8 8 5 7 9 7 8 7 9 9 7 8 5 7 9 7 8 9 9 7
4 7 8 6 7 8 6 7 8 6 7 8 6 7 8 6 7 8 6 7 8 6 7 8 6 7 8 6 7 8 6 7 8 10
4 7 9 6 10 9 5 10 8 5 10 9 6 10 8 5 10 9 6 10 8 5 10 9 6 10 8 5 10 9 6 10 8 5
4 5 11 26 6 7 8 18 10 22 13 14 9 10 22 17 17 28 6 17 18 28 10 22 7 17 24 25 26 28 17 17 18 28
4 6 1 4 2 4 2 4 2 4 2 4 2 4 2 4 2 4 2 4 2 4 2 4 2 4 2 4 2 4 2 4 2 4 2 4 2 4 2 4 2 4 2 4 2 4 2 4 2 4 2 4 2 4 2 4 2 4 2 4 2 4 2 4 2 4 2 4 2 4 2 4 2 4 2 4 2 4 2 4
4 14 6 7 8 9 5 11 12 13 15 5 11 12 13 15 5 11 12 13 15 5 11 12 13 15 5 11 12 13 15 5 11 12
4 7 2 4 7 2 4 7 2 4 7 2 4 7 2 4 7 2 4 7 2 4 7 2 4 7 2 4 7 2 4 7 7 7 8
4 5 8 12 13 10 11 15 16 8 12 13 10 11 15 16 8 12 13 10 11 15 16 8 12 13 10 11 15 16 8 12 6 10 11
4 5 1 4 5 2 4 5 6 5 6 5 6 5 6 5 6 5 6 5 2 4 5 6 5 6 5 6 5 6 5 6 5 6 5 6 5 6 5 6 5 6 5 6 5 6 5 6 5 6 5 6 5 6 5 6 5 6 5 6 5 6 5 6 5 6 5 6 5 6 5 6 5 6 5 6 5 6 5 6
4 5 7 6 11 8 9 7 9 8 7 9 7 9 7 9 7 9 8 11 7 9 7 9 7 9 8 11 7 9 7 9 7 12
4 5 7 9 6 8 9 6 6 1 4 5 7 9 6 6 8 9 6 6 8 9 6 1 4 5 7 9 6 6 8 9 6 6
4 5 17 18 8 9 15 16 17 18 6 20 26 25 26 17 18 15 20 26 25 26 17 18 15 20 26 25 26 17 18 15 20 26 25 26
4 5 6 7 7 6 7 6 7 6 7 6 7 6 7 6 7 6 7 6 7 6 7 6 7 6 7 6 7 6 7 6 7 5
4 5 9 8 10 7 9 8 6 8 7 11 9 8 6 8 7 11 9 8 6 8 7 11 9 8 6 8 7 11 9 8 6 8
4 5 6 8 9 10 9 10 5 15 7 11 15 5 15 5 9 10 5 15 7 11 15 5 15 5 9 10 5 15 7 11 15 5
4 5 6 7 10 13 13 6 9 7 10 13 13 1 4 5 6 11 10 11 10 9 13 6 8 7 10 13 13 1 4 5 6 11 10 11 10 9 13 13
4 5 6 1 4 5 6 7 5 6 2 4 5 6 7 5 6 6 2 4 5 5 6 6 7 5 6 7 5 6 6 7 5 6 6
4 6 5 6 7 1 4 5 6 7 5 6 7 1 4 5 6 7 5 6 7 5 6 7 1 2 4 5 6 7 5 6 7 5 6
4 6 5 1 2 4 6 5 6 2 4 6 5 6 2 4 6 5 6 2 4 6 5 6 5 2 4 6 5 6 2 4 6 5 6 5
4 9 7 9 10 12 12 5 10 10 12 9 12 5 10 12 9 12 5 10 10 12 5 7 5 10 12 9 12 12 5 10 10 12
4 5 6 7 7 8 5 6 7 1 2 4 5 7 6 7 7 8 5 6 7 8 5 6 7 7 8 5 1 4 5 7 6 7
4 5 2 4 5 6 5 2 4 5 2 4 5 5 6 5 6 5 6 5 6 5 6 5 6 5 6 5 6 5 6 5 6 5 6 5 6 5 6 5 6 5 6 5 6 5 6 5 6 5 6
4 8 8 12 11 13 8 8 12 11 13 8 8 12 11 13 8 8 12 11 13 8 8 12 11 13 8 8 12 11 13 8 8 12 11 13
4 5 6 1 4 5 6 5 1 4 5 6 5 2 4 5 6 5 6 5 1 4 5 6 5 6 5 2 4 5 6 5 6 5 6
4 8 6 7 9 8 9 8 5 9 8 8 7 9 5 8 9 5 7 8 9 8 8 9 8 8 9 8 7 5 9 5 5 9
4 5 2 4 5 2 4 5 2 4 5 2 4 5 2 4 5 2 4 5 2 4 5 2 4 5 2 4 5 2 4 5 2 4 5 2 4 5 2 4 5 2 4 5 2 4 5 2 4 5 2 4 5 2 4 5 2 4 5 2 4 5 2 4 5 2 4 5 2 4 5 2 4 5 2 4 5 2 4 5
4 6 7 1 4 7 5 4 6 6 6 7 5 2 4 2 4 2 4 2 4 2 4 2 4 2 4 2 4 2 4 2 4 2 4 2 4 2 4 2 4 2 4 2 4 2 4 2 4 2 4 2 4 2 4 2 4 2 4 2 4 2 4 2 4 2 4 2 4 2 4 2 4 2 4 2 4 2 4 2
4 5 12 14 13 14 11 6 14 6 14 6 6 14 6 14 11 6 14 6 14 8 6 14 6 14 11 6 14 6 14 8 11 14
4 8 7 8 8 1 4 8 7 7 8 8 8 7 8 8 1 4 8 7 7 5 7 7 8 7 8 8 8 7 8 1 4 8 7 8 8 8 8
4 5 8 7 11 10 11 9 10 11 5 8 11 5 10 11 9 10 11 9 8 11 9 10 11 9 10 11 9 8 11 5 10 11
4 7 6 7 5 8 7 7 7 8 6 7 5 8 7 7 7 8 6 7 5 8 7 7 7 8 6 7 5 8 5 6 7 5
