4 5 7 1 4 5 6 7 5 6 4 5 6 5 7 6 5 6 7 5 6 4 5 6 5 7 6 5 6 7 5 6 5 7
4 5 7 11 19 22 20 22 22 21 22 20 22 22 21 22 20 22 22 21 22 20 22 22 21 22 20 22 22 21 22 20 22 22
4 5 5 6 6 8 1 4 4 4 4 4 4 4 4 4 4 4 4 4 4 4 4 4 4 4 4 4 4 4 4 4 0 4 4 4 0 4 4 4 4 0 4 4 4 0 4 4 4 4 0 4 4 4 4 4 0 4 4 4 0 4 4 4 0 4 4 4 4 0 4 4 4 4 0 4 4 4 4 4
4 5 6 2 4 5 6 5 6 4 5 6 5 6 5 6 5 6 5 6 4 5 6 5 6 5 6 5 6 5 6 5 6 5
4 5 8 10 7 8 10 11 7 9 10 7 9 10 7 9 10 7 9 10 7 9 10 7 9 10 7 9 10 7 9 10 7 8
4 5 12 7 8 11 12 11 6 13 5 7 8 9 11 12 11 6 13 5 7 8 9 11 12 11 6 13 5 7 8 9 11 12
4 9 7 8 10 11 6 8 10 11 6 8 10 11 6 8 10 11 6 8 10 11 6 8 10 11 6 8 10 11 6 8 10 11
4 13 11 6 10 12 12 10 9 8 9 10 10 12 5 9 8 9 10 10 12 7 9 8 9 10 10 12 12 10 9 8 9 10
4 5 10 7 12 13 5 12 13 11 10 7 10 11 11 12 13 5 12 13 11 10 7 10 11 11 12 13 5 12 13 11 10 11
4 5 8 7 6 9 7 8 5 6 7 8 5 5 6 7 8 9 5 6 7 8 9 5 6 7 8 9 5 6 7 8 9 5
4 5 6 8 7 6 7 9 10 11 5 10 11 6 7 9 8 6 7 9 7 9 7 6 8 9 10 11 5 10 11 6 9 11
4 5 6 7 7 6 7 5 8 8 9 5 8 9 5 8 8 9 7 6 7 6 8 8 9 5 8 9 5 8 8 9 7 6
4 5 6 7 8 1 4 5 6 7 7 6 7 8 1 4 5 6 7 7 6 7 8 1 4 5 6 7 7 6 7 8 5 8
4 5 8 5 7 8 5 12 13 11 5 13 11 7 8 5 12 13 11 11 12 13 11 5 7 8 5 12 13 11 11 12 13 11
4 6 4 6 4 5 4 5 4 5 4 5 4 5 4 5 4 5 4 5 4 5 4 5 4 5 4 5 4 5 4 5 4 5 4 5 4 5 4 5 4 5 4 5 4 5 4 5 4 5 4 5 4 5 4 5 4 5 4 5 4 5 4 5 4 5 4 5 4 5 4 5 4 5 4 5 4 5 4 5
4 5 15 16 8 7 7 15 16 10 13 12 19 14 15 16 10 13 13 19 5 13 19 5 13 19 10 12 14 19 5 13 19 10 12
4 6 7 4 6 7 4 6 7 4 7 4 6 7 4 6 7 4 7 4 6 7 4 6 7 4 7 4 6 7 4 6 7 4 7 4 6 7 4 6 7 4 7 4 6 7 4 6 7 4 7 4 6 7 4 6 7 4 7 4 6 7 4 6 7 4 7 4 6 7 4 6 7 4 7 4 6 7 4 6
4 20 7 14 9 11 12 13 8 17 18 19 16 12 20 19 16 17 7 14 6 9 19 15 16 17 7 14 6 9 19 15 16 6
4 6 7 7 8 8 1 4 6 5 6 7 5 6 7 8 8 1 4 6 5 6 7 5 6 7 7 8 8 1 4 6 6 7 7 8 8
4 6 6 7 8 5 6 6 5 7 8 6 6 6 5 7 8 6 6 6 5 7 8 6 6 6 5 7 8 6 6 6 5 7 8
4 5 6 1 4 5 7 5 6 7 5 6 7 5 6 7 4 5 5 6 7 4 5 5 6 7 5 6 7 5 6 7 5 6
4 5 12 13 8 10 9 8 10 10 12 13 8 10 9 11 12 13 8 10 10 12 13 8 10 9 11 12 13 8 10 10 9 8 10 10 12 13 8 10 9 11 12 13 8 10 10 12 13 8 10 9 11 12 13 8 10 10 9 8 10 10 12 13 8 10 9 11 12 13 8 10 10 12 13 8 10 9 11 12
4 5 6 2 4 5 6 5 6 4 5 6 5 6 5 6 5 6 4 5 6 5 6 5 6 5 6 5 6 5 6 5 6 5
4 5 6 12 8 15 16 15 20 18 7 21 10 6 19 24 5 22 23 8 9 20 6 7 24 5 22 23 24 5 13 14 17 24
4 5 6 7 12 12 9 7 12 5 12 9 7 12 5 12 9 7 12 5 12 9 7 12 5 12 9 7 12 5 12 5 7 12
4 5 8 10 7 10 7 10 7 10 7 9 5 10 8 7 10 7 10 7 10 7 10 7 10 7 10 7 10 5 10 8 7 9
4 5 11 9 11 8 8 9 11 8 8 9 11 8 9 11 8 8 9 11 8 8 9 11 8 9 11 8 8 9 11 11 9 8
4 5 2 4 5 5 6 1 4 5 5 6 2 4 5 5 5 6 6 1 4 5 5 6 2 4 5 5 5 6 7 5 6 7
4 5 6 7 14 15 14 11 16 5 19 5 14 10 16 13 16 5 19 5 14 10 16 5 19 5 14 13 16 5 19 5 14 10
4 5 7 5 7 5 5 5 1 4 5 8 7 8 7 5 5 7 5 5 5 7 5 5 7 5 5 5 7 5 5 7 5 5
4 5 5 8 6 7 7 8 7 8 7 8 7 8 7 8 7 8 7 8 6 6 5 8 7 7 8 6 7 7 8 7 8 7
4 5 6 5 7 1 4 5 6 5 7 8 1 4 5 6 5 6 7 1 4 5 6 5 7 1 4 5 6 5 6 7 7 8
4 5 6 7 8 12 9 13 11 14 13 14 12 9 13 11 12 13 11 14 9 13 14 12 8 14 9 13 11 12 13 14 9 13
4 5 6 8 6 5 8 1 4 5 6 8 5 8 6 5 8 6 5 8 1 4 5 6 8 5 8 6 5 8 6 5 8 6
4 5 6 10 11 8 9 11 9 8 11 9 11 9 8 11 9 11 9 8 11 9 11 9 8 11 9 11 8 9 11 9 8 11
4 5 6 6 7 6 5 7 1 4 5 5 6 7 6 6 5 7 6 5 7 1 4 5 5 6 7 6 6 5 7 6 5 7
4 8 15 23 10 17 12 20 21 13 24 21 22 24 21 13 24 21 13 24 21 13 24 21 13 24 21 13 24 21 13 24 21 13 24 21 13 24 21 13 24 21 13 24 21 13 24 21 13 24 21 13 24 21 13 24 21 13 24 21 13 24 21 13 24 21 13 24 21 13 24 21 13 24 21 13 24 21 9 24
4 5 6 7 8 7 6 7 8 7 6 7 8 7 6 7 8 7 6 7 8 7 6 7 8 7 6 7 8 7 6 7 8 7
4 5 7 5 5 5 5 5 5 5 7 5 5 5 5 5 7 5 5 5 5 5 7 7 5 5 7 5 5 7 5 5 5 5
4 6 4 5 4 5 4 5 4 5 4 5 4 5 4 5 4 5 4 5 4 5 4 5 4 5 4 5 4 5 4 5 4 5 4 5 4 5 4 5 4 5 4 5 4 5 4 5 4 5 4 5 4 5 4 5 4 5 4 5 4 5 4 5 4 5 4 5 4 5 4 5 4 5 4 5 4 5 4 6
4 7 20 23 12 10 19 24 10 19 24 21 22 10 21 19 24 10 19 24 21 22 10 21 19 24 10 19 24 21 22 10 21 19 24 10 9
4 5 6 2 4 5 6 5 6 4 5 6 5 6 5 6 5 6 4 5 6 5 6 5 6 5 6 5 6 5 6 5 6 5
4 5 4 5 4 5 4 5 4 5 4 5 4 5 4 5 4 5 4 5 4 5 4 5 4 5 4 5 4 5 4 5 4 5 4 5 4 5 4 5 4 5 4 5 4 5 4 5 4 5 4 5 4 5 4 5 4 5 4 5 4 5 4 5 4 5 4 5 4 5 4 5 4 5 4 5 4 5 4 5
4 5 6 7 7 7 7 1 4 5 6 7 7 7 7 7 7 7 7 7 7 7 7 7 7 7 7 7 7 7 7 7 7 7
4 5 5 7 8 10 9 11 11 6 6 7 8 10 10 11 11 6 6 7 8 10 10 11 11 6 6 7 8 10 10 11 11 6 6 7 8 10 10 11
4 5 7 6 7 1 4 5 6 7 6 7 5 6 7 1 4 5 6 7 6 7 5 6 7 1 4 5 6 7 6 7 6 7
4 5 4 5 4 5 4 4 5 4 5 4 2 4 4 5 4 2 4 4 2 4 4 5 4 2 4 4 5 4 2 4 4 5 4 2 4 4 5 4 2 4 4 5 4 2 4 4 5 4 2 4 4 5 4 2 4 4 5 4 2 4 4 5 4 2 4 4 5 4 2 4 4 5 4 2 4 4 2 4
4 7 5 8 6 7 8 9 7 7 8 6 7 8 9 7 5 9 7 8 6 9 7 8 9 7 7 8 9 6 7 8 9 7
4 5 6 7 8 6 6 7 8 6 6 7 8 6 6 7 8 6 6 7 8 6 6 7 8 6 6 7 8 6 6 5 7 8
4 6 6 6 8 10 9 11 11 6 6 8 9 9 11 6 6 8 9 9 11 6 6 8 9 9 11 6 6 8 9 9 11 11
4 9 6 7 8 7 5 7 9 7 7 5 7 9 7 7 5 7 9 7 7 5 7 9 7 7 5 7 9 7 7 5 7 5
4 7 8 6 7 8 6 7 8 6 7 8 6 7 8 6 7 8 6 7 8 6 7 8 6 7 8 6 7 8 6 7 8 6
4 7 9 6 9 5 8 5 9 6 10 8 5 9 6 10 8 5 9 6 10 8 5 9 6 10 8 5 9 6 10 8 5 10
4 5 11 14 6 7 8 20 22 10 23 25 14 21 10 28 19 5 16 28 19 23 10 22 17 16 28 19 23 10 22 17 16 28
4 6 5 4 6 5 4 5 4 5 4 5 4 5 4 5 4 5 4 5 4 5 4 5 4 5 4 5 4 5 4 5 4 5 4 5 4 5 4 5 4 5 4 5 4 5 4 5 4 5 4 5 4 5 4 5 4 5 4 5 4 5 4 5 4 5 4 5 4 5 4 5 4 5 4 5 4 5 4 5
4 5 6 9 8 9 7 5 11 12 13 15 5 11 12 13 15 5 11 12 13 15 5 11 12 13 15 5 11 12 13 15 5 11 12
4 5 4 7 5 4 7 7 5 4 7 5 4 7 7 7 5 4 7 5 4 7 7 7 5 4 7 5 4 7 7 7 7 7
4 5 6 10 8 11 12 6 14 12 11 12 13 14 12 11 12 6 14 12 11 12 6 14 12 11 12 13 14 12 11 12 13 14
4 6 4 5 6 5 6 4 5 6 5 6 5 6 5 6 5 6 4 5 6 5 6 5 6 5 6 5 6 5 6 5 6 5
4 5 7 6 9 10 11 7 9 11 9 7 9 8 11 7 9 9 11 7 9 8 11 9 7 9 8 11 9 7 9 8 11 12
4 5 6 9 6 8 9 6 8 9 7 8 9 7 8 9 7 8 9 7 8 9 7 8 9 7 8 9 7 8 9 7 5 8
4 5 7 13 9 16 17 18 6 19 26 25 20 26 17 18 15 20 26 17 18 6 20 26 25 26 17 18 15 20 26 25 9 26
4 5 6 7 7 5 7 5 7 5 7 5 7 5 7 5 7 5 7 5 7 5 7 5 7 5 7 5 7 5 7 5 7 5
4 5 9 8 6 11 7 10 9 8 8 6 8 7 11 9 7 5 8 6 8 7 11 9 7 5 8 6 8 7 11 9 8 8
4 5 6 7 8 9 10 11 15 7 11 15 12 5 6 15 7 5 15 12 6 5 15 9 12 5 15 7 5 15 6 10 5 15
4 5 6 8 11 10 10 13 9 6 7 10 7 10 13 9 6 7 10 10 11 10 13 9 6 7 10 10 11 10 13 9 7 13
4 7 4 5 6 7 4 5 7 4 5 5 6 7 4 5 5 6 7 4 5 5 6 7 4 5 5 6 7 4 5 5 6 5 6
4 6 7 5 6 6 7 6 6 6 7 5 6 6 6 7 6 6 6 7 5 6 6 6 7 5 6 6 6 7 5 6 6 7
4 6 5 1 4 6 5 6 1 4 6 5 6 5 1 4 6 5 6 5 1 4 6 5 6 5 1 4 6 5 6 5 6 5
4 9 7 5 10 12 5 12 12 5 10 10 12 5 12 12 9 10 10 12 5 12 12 9 10 10 12 5 12 12 9 10 10 12
4 5 6 7 7 8 5 6 7 7 8 4 5 6 7 7 8 5 6 7 7 8 5 8 5 7 6 7 7 8 4 5 6 7 7
4 5 6 4 5 6 4 5 5 6 4 5 6 5 6 5 6 5 6 5 6 4 5 6 5 6 5 6 5 6 5 6 5 6 5
4 8 7 4 8 7 4 8 7 4 8 7 4 8 7 4 8 7 4 8 7 4 8 7 4 8 7 4 8 7 4 8 7 4 8 7 4 8 7 4 8 7 4 8 7 4 8 7 4 8 7 4 8 7 4 8 7 4 8 7 4 8 7 4 8 7 4 8 7 4 8 7 4 8 7 4 8 7 4 8
4 4 5 6 6 1 4 5 6 6 6 6 5 6 6 6 6 5 6 1 4 5 6 6 6 6 5 6 6 6 6 5 6 6
4 5 6 7 8 9 7 8 9 7 8 9 7 8 9 7 8 9 7 8 9 7 8 9 7 8 9 7 8 9 7 8 9 7
4 5 4 5 5 4 5 4 5 5 4 5 5 4 5 5 4 5 5 4 5 5 4 5 5 4 5 5 4 5 5 4 5 5 4 5 5 4 5 5 4 5 5 4 5 5 4 5 5 4 5 5 4 5 5 4 5 5 4 5 5 4 5 5 4 5 5 4 5 5 4 5 5 4 5 5 4 5 5 4
4 6 5 7 7 5 4 5 4 5 4 5 4 5 4 5 4 5 4 5 4 5 4 5 4 5 4 5 4 5 4 5 4 5 4 5 4 5 4 5 4 5 4 5 4 5 4 5 4 5 4 5 4 5 4 5 4 5 4 5 4 5 4 5 4 5 4 5 4 5 4 5 4 5 4 5 4 5 4 5
4 5 12 9 6 8 14 6 6 14 8 6 14 8 6 14 8 6 14 8 6 14 8 6 14 8 6 14 8 6 14 8 8 14
4 8 7 7 7 8 7 8 7 8 7 8 7 8 7 8 7 8 7 8 7 8 7 8 7 8 7 8 7 8 7 8 7 8
4 5 8 11 7 9 10 11 9 10 11 9 10 11 9 10 11 9 10 11 9 10 11 9 10 11 9 10 11 9 10 11 9 10
4 7 6 7 7 7 7 7 7 7 7 7 7 7 7 7 7 7 7 7 7 7 7 7 7 7 7 7 7 7 7 7 7 5
