4 5 6 4 5 6 4 5 6 4 5 5 6 4 5 6 4 5 5 6 4 5 5 6 4 5 6 4 5 5 6 4 5 5 6 4 5 6 4 5 5 6 4 5 5 6 4 5 6 4 5 5 6 4 5 5 6 4 5 6 4 5 5 6 4 5 5 6 4 5 6 4 5 5 6 4 5 5 6 4
4 5 7 11 19 22 20 22 22 22 22 20 22 22 22 22 20 22 22 19 22 20 22 22 22 22 20 22 22 22 22 20 22 22
4 5 5 6 7 8 1 4 6 5 6 7 8 5 5 6 7 8 1 4 6 5 5 6 7 8 5 6 6 8 8 5 6 7 8
4 5 6 4 5 6 4 5 6 4 5 5 6 4 5 6 4 5 5 6 4 5 5 6 4 5 6 4 5 5 6 4 5 5 6 4 5 5 6 4 5 6 4 5 5 6 4 5 5 6 4 5 5 6 4 5 6 4 5 5 6 4 5 5 6 4 5 5 6 4 5 6 4 5 5 6 4 5 5 6
4 5 9 7 9 10 10 11 7 9 10 10 11 7 9 10 10 11 7 9 10 10 11 7 9 10 10 11 7 9 10 10 11 7 8
4 5 12 11 8 9 11 6 13 6 7 8 9 11 12 9 6 13 9 9 11 6 13 6 7 8 9 11 12 9 11 5 13 5
4 5 6 7 8 10 11 9 8 10 11 5 8 10 11 5 8 10 11 5 8 10 11 5 7 8 10 11 5 8 10 11 9 8 10 11
4 5 11 6 12 10 12 7 8 9 9 8 9 12 7 9 8 9 9 8 9 12 12 7 9 8 9 9 8 9 12 12 7 9 8 9
4 7 10 11 12 13 5 12 13 5 12 13 5 7 10 5 12 13 5 12 13 5 12 13 5 7 10 5 12 13 5 12 13 11
4 9 6 7 8 9 7 8 5 7 8 9 6 7 8 9 9 7 8 5 6 7 8 9 9 7 8 5 6 7 8 9 9 7 8 5
4 5 6 7 8 6 7 9 10 11 9 9 11 11 6 7 6 9 7 9 10 11 9 11 6 7 6 9 10 11 9 9 10 11
4 5 6 8 9 8 7 6 8 9 8 7 6 8 9 8 7 6 8 9 8 7 6 8 9 8 7 6 8 9 8 7 6 9
4 5 6 7 7 8 8 5 6 7 7 6 7 8 1 4 5 6 7 7 7 6 7 7 8 5 6 7 7 8 5 6 7 8
4 5 8 11 7 8 11 7 8 11 7 13 11 5 12 13 11 11 7 8 11 7 8 11 7 11 10 5 12 13 11 11 12 13
4 6 4 6 4 6 4 6 4 6 4 6 4 6 4 6 4 6 4 6 4 6 4 6 4 6 4 6 4 6 4 6 4 7
4 5 10 8 7 8 14 15 16 17 10 12 14 15 16 12 11 12 14 19 10 12 14 15 16 17 10 13 14 19 13 14 19 12 14 19
4 6 10 9 8 9 10 1 4 6 7 4 6 7 4 6 7 4 6 7 4 7 4 6 7 4 6 7 4 7 4 6 7 4 6 7 4 7 4 6 7 4 6 7 4 7 4 6 7 4 6 7 4 7 4 6 7 4 6 7 4 7 4 6 7 4 6 7 4 7 4 6 7 4 6 7 4 6 7 4
4 6 14 9 11 12 7 8 17 18 19 12 7 8 12 9 19 16 17 7 8 12 9 19 6 17 7 8 12 9 19 16 17 7 8 12 18 19 6
4 6 7 7 8 8 1 4 6 5 4 6 6 5 4 6 6 5 4 6 6 5 4 6 6 5 4 6 6 5 4 6 6 5 4 6 6 5 4 6 6 5 4 6 6 5 4 6 6 5 4 6 6 5 4 6 6 5 4 6 6 5 4 6 6 5 4 6 6 5 4 6 6 5 4 6 6 5 4 6
4 6 6 7 8 5 5 5 5 7 8 5 5 5 5 7 8 5 5 5 5 7 8 5 5 5 5 7 8 5 5 5 5 7 8
4 5 6 1 4 5 7 4 5 5 7 4 5 7 4 5 5 7 4 5 7 4 5 5 7 4 5 7 4 5 5 7 4 5 5 7 4 5 7 4 5 5 7 4 5 7 4 5 5 7 4 5 5 7 4 5 7 4 5 5 7 4 5 7 4 5 5 7 4 5 5 7 4 5 7 4 5 5 7 4
4 12 11 9 8 10 9 11 12 13 8 10 9 11 9 8 10 9 11 12 13 8 10 9 11 9 8 10 9 11 12 13 8 10 9 11 9 8 10 9 11 12 13 8 10 9 11 9 8 10 9 11 12 13 8 10 9 11 9 8 10 9 11 12 13 8 10 9 11 9 8 10 9 11 12 13 8 10 9 11
4 5 6 4 5 6 4 5 6 4 5 5 6 4 5 6 4 5 5 6 4 5 5 6 4 5 6 4 5 5 6 4 5 5 6 4 5 5 6 4 5 6 4 5 5 6 4 5 5 6 4 5 6 4 5 5 6 4 5 5 6 4 5 5 6 4 5 6 4 5 5 6 4 5 5 6 4 5 5 6
4 5 21 9 15 20 11 19 8 14 17 21 10 11 7 8 24 13 14 17 21 9 20 18 7 8 14 24 13 10 11 19 8 14 24
4 5 6 7 12 12 9 7 12 12 9 7 12 12 5 7 12 5 12 9 7 12 5 12 9 7 12 5 12 9 7 12 9 12
4 5 6 10 7 10 6 10 7 10 6 9 7 10 8 10 7 10 8 10 7 10 6 10 7 10 8 10 7 10 8 10 7 10
4 8 9 11 8 9 11 8 9 11 8 9 11 8 9 11 8 9 11 8 9 11 8 9 11 8 9 11 8 9 11 8 9 8
4 5 6 1 4 5 5 6 2 4 5 5 5 6 2 4 5 5 5 6 2 4 5 5 5 6 2 4 5 5 5 5 6 7
4 5 6 7 14 15 12 11 19 11 14 5 19 11 14 5 19 11 14 5 19 11 14 10 16 11 19 11 14 5 19 11 14 5
4 5 7 7 5 5 1 4 5 6 4 5 6 4 5 6 4 5 6 4 5 6 4 5 6 4 5 6 4 5 6 4 5 6 4 5 6 4 5 6 4 5 6 4 5 6 4 5 6 4 5 6 4 5 6 4 5 6 4 5 6 4 5 6 4 5 6 4 5 6 4 5 6 4 5 6 4 5 6 4
4 7 6 5 8 7 8 5 7 8 7 5 8 7 6 5 5 8 7 8 5 7 8 7 6 5 5 8 7 8 5 5 8 5
4 5 6 7 1 4 5 6 5 7 1 4 5 6 5 6 7 2 4 5 6 5 6 7 8 5 6 7 8 5 1 4 5 6 5 7 8
4 5 6 7 8 5 9 10 11 12 10 11 12 14 14 5 13 11 12 10 11 12 8 5 12 13 14 14 12 10 11 12 10 14
4 6 5 6 8 1 4 5 6 8 5 6 5 8 1 4 5 6 8 5 6 5 8 1 4 5 6 5 8 7 4 5 6 5 8 6 5 8
4 5 11 9 8 11 9 6 10 11 9 8 11 6 9 8 11 10 9 6 8 11 9 8 11 9 6 10 11 9 8 11 9 10
4 6 5 7 1 4 5 6 6 5 7 1 4 5 6 5 7 6 6 5 7 1 4 5 6 5 7 6 6 7 1 4 5 5 6 7
4 8 15 23 10 22 24 10 22 24 10 22 24 10 22 24 10 22 24 10 22 24 10 22 24 10 22 24 10 22 24 10 22 24
4 5 6 7 8 7 6 7 8 7 6 7 8 7 6 7 8 7 6 7 8 7 6 7 8 7 6 7 8 7 6 7 8 7 6
4 5 7 5 5 1 4 5 6 7 5 6 7 5 5 6 7 5 5 5 6 7 5 5 5 6 7 5 5 5 6 7 5 6
4 6 4 5 4 5 4 5 4 5 4 5 4 5 4 5 4 5 4 5 4 5 4 5 4 5 4 5 4 5 4 5 4 5 4 5 4 5 4 5 4 5 4 5 4 5 4 5 4 5 4 5 4 5 4 5 4 5 4 5 4 5 4 5 4 5 4 5 4 5 4 5 4 5 4 5 4 5 4 6
4 7 20 23 12 10 22 24 10 9 24 21 8 25 22 10 24 26 24 21 22 24 21 13 24 21 13 10 24 19 24 21 22 24
4 5 6 4 5 6 4 5 6 4 5 5 6 4 5 6 4 5 5 6 4 5 6 4 5 5 6 4 5 5 6 4 5 6 4 5 5 6 4 5 5 6 4 5 6 4 5 5 6 4 5 5 6 4 5 6 4 5 5 6 4 5 6 4 5 5 6 4 5 5 6 4 5 6 4 5 5 6 4 5
4 5 4 5 4 5 4 5 4 5 4 5 4 5 4 5 4 5 4 5 4 5 4 5 4 5 4 5 4 5 4 5 4 5 4 5 4 5 4 5 4 5 4 5 4 5 4 5 4 5 4 5 4 5 4 5 4 5 4 5 4 5 4 5 4 5 4 5 4 5 4 5 4 5 4 5 4 5 4 5
4 5 6 7 7 1 4 5 7 6 7 7 7 1 4 5 7 6 7 7 5 6 7 7 1 4 5 7 6 7 7 5 7 7
4 6 5 7 8 9 9 11 5 5 5 7 8 9 9 11 11 6 6 6 7 8 9 9 11 11 6 6 6 7 8 9 9 11
4 5 6 7 1 4 5 6 7 7 6 7 7 6 5 1 4 5 6 7 7 7 6 7 7 6 7 5 1 4 5 6 7 7
4 5 4 5 4 5 4 5 4 5 4 5 4 5 4 5 4 5 4 5 4 5 4 5 4 5 4 5 4 5 4 5 4 6
4 5 6 7 8 9 7 5 8 9 7 7 8 9 6 7 8 9 7 5 8 9 6 7 8 9 7 5 8 9 6 7 8 9
4 5 6 7 8 6 6 7 8 6 6 7 8 6 6 7 8 6 6 7 8 6 6 7 8 6 6 7 8 6 6 7 8 6
4 6 6 9 10 11 11 6 8 10 10 11 11 6 8 10 10 11 11 6 8 10 10 11 11 6 8 11 9 9 11 11 6 8 11
4 5 6 8 7 9 5 7 5 7 5 8 5 7 5 7 9 8 7 9 5 7 9 8 7 9 5 7 9 8 7 9 9 7
4 7 8 6 7 8 6 7 8 6 7 8 6 7 8 6 7 8 6 7 8 6 7 8 6 7 8 6 7 8 6 7 8 6
4 7 6 9 7 8 10 6 7 9 5 8 10 6 5 9 5 8 10 6 5 9 5 8 10 6 5 9 5 8 10 9 6 10
4 5 13 26 8 27 16 21 25 14 12 10 22 17 12 13 14 6 28 17 23 10 28 17 17 18 28 12 10 22 17 23 25 14 6 28
4 6 5 4 6 5 4 5 4 5 4 5 4 5 4 5 4 5 4 5 4 5 4 5 4 5 4 5 4 5 4 5 4 5 4 5 4 5 4 5 4 5 4 5 4 5 4 5 4 5 4 5 4 5 4 5 4 5 4 5 4 5 4 5 4 5 4 5 4 5 4 5 4 5 4 5 4 5 4 5
4 14 6 7 10 9 8 15 5 11 12 13 15 5 11 15 5 13 15 5 11 10 13 15 5 11 15 5 13 15 5 11 10 13
4 7 2 4 7 7 7 7 8 1 4 5 4 7 5 4 7 5 4 7 5 4 7 5 4 7 5 4 7 5 4 7 7 7 8
4 5 8 12 6 10 7 15 16 8 12 6 10 7 15 16 8 12 6 7 15 16 8 12 6 7 15 16 8 12 13 7 15 16
4 5 6 4 5 6 4 5 6 4 5 6 5 6 4 5 6 5 6 4 5 6 5 6 4 5 6 5 6 4 5 6 5 6 4 5 6 5 6 4 5 6 5 6 4 5 6 5 6 4 5 6 5 6 4 5 6 5 6 4 5 6 5 6 4 5 6 5 6 4 5 6 5 6 4 5 6 5 6 4
4 5 7 6 9 10 11 9 7 7 9 8 11 7 9 7 9 11 7 9 8 11 7 9 7 9 11 7 9 8 11 7 6 12
4 5 9 6 8 9 6 1 4 5 6 8 9 6 8 9 6 1 4 5 7 9 7 8 9 6 8 9 6 1 4 5 7 9 6 8 9 6
4 5 6 7 8 9 16 17 18 15 11 6 20 16 17 18 24 25 26 25 11 23 20 15 16 17 18 24 25 26 25 11 23 20 15
4 5 5 7 7 6 7 6 7 6 7 6 7 6 7 6 7 6 7 6 7 6 7 6 7 6 7 6 7 6 7 6 7 6
4 5 9 7 11 6 8 7 6 8 8 7 9 8 6 8 7 7 9 8 6 8 7 11 9 8 6 8 7 7 9 8 6 8 7
4 5 6 8 9 12 5 15 7 11 15 12 9 5 15 7 11 15 12 9 5 15 7 11 15 12 9 5 15 7 11 15 12 9
4 5 6 11 10 13 6 8 11 10 13 6 9 11 10 13 1 4 5 6 11 8 10 11 8 13 6 9 13 6 11 9 13 6
4 6 2 4 5 7 4 5 5 6 6 7 4 5 5 6 6 7 4 5 5 6 6 7 4 5 5 6 6 7 4 5 5 6 6 7 4 5 5 6 6 7 4 5 5 6 6 7 4 5 5 6 6 7 4 5 5 6 6 7 4 5 5 6 6 7 4 5 5 6 6 7 4 5 5 6 6 7 4 5
4 6 7 6 6 7 1 4 5 6 7 5 6 7 6 6 6 7 1 4 5 6 7 5 7 6 6 6 7 1 4 5 6 7 5 6 7
4 6 5 1 4 6 5 2 4 6 5 6 5 1 4 6 5 6 5 2 4 6 5 6 5 6 2 4 6 5 6 5 1 4 6 5 6 5
4 5 7 9 10 12 5 12 12 5 10 10 12 9 7 9 10 10 12 5 10 12 9 10 10 12 9 7 9 10 12 9 10 12
4 5 6 7 1 4 5 8 4 5 7 6 7 7 5 8 4 5 7 6 7 7 5 8 4 5 7 6 7 7 8 5 7 6 7
4 5 6 4 5 6 4 5 6 4 5 5 6 4 5 6 4 5 5 6 4 5 5 6 4 5 6 4 5 5 6 4 5 5 6 4 5 6 4 5 5 6 4 5 5 6 4 5 6 4 5 5 6 4 5 6 4 5 5 6 4 5 5 6 4 5 6 4 5 5 6 4 5 6 4 5 5 6 4 5
4 8 9 12 11 13 8 9 12 11 13 13 8 8 12 11 5 13 8 9 12 12 13 8 9 12 11 5 13 8 12 11 8 13
4 6 5 1 4 5 6 6 6 5 1 4 5 6 5 6 1 4 5 6 5 6 5 6 6 5 1 4 5 6 5 6 6 5
4 8 6 7 8 9 8 9 5 8 9 5 5 9 5 5 9 5 5 9 5 5 9 5 5 9 5 5 9 5 5 9 5 5
4 5 4 5 4 5 5 4 5 4 5 4 5 4 5 4 5 4 5 4 5 4 5 4 5 4 5 4 5 4 5 4 5 4 5 4 5 4 5 4 5 4 5 4 5 4 5 4 5 4 5 4 5 4 5 4 5 4 5 4 5 4 5 4 5 4 5 4 5 4 5 4 5 4 5 4 5 4 5 4
4 6 5 4 5 4 5 4 5 4 5 4 5 4 5 4 5 4 5 4 5 4 5 4 5 4 5 4 5 4 5 4 5 4 5 4 5 4 5 4 5 4 5 4 5 4 5 4 5 4 5 4 5 4 5 4 5 4 5 4 5 4 5 4 5 4 5 4 5 4 5 4 5 4 5 4 5 4 5 4
4 5 12 14 9 11 8 8 6 14 8 8 8 8 6 14 8 8 8 8 6 14 8 8 8 8 6 14 8 8 8 8 8 14
4 8 2 4 7 7 8 8 8 8 8 1 4 7 5 4 7 7 7 8 8 8 8 8 8 8 8 1 4 8 7 8 8 8
4 9 8 7 9 10 11 9 10 11 9 8 11 9 10 7 9 10 11 9 10 11 9 8 11 9 10 7 9 10 11 5 10 11
4 7 6 6 7 1 4 7 7 8 4 5 6 7 7 8 4 5 6 7 7 8 4 5 6 7 7 8 4 5 6 7 7 8 4 5 6 7 7 8 4 5 6 7 7 8 4 5 6 7 7 8 4 5 6 7 7 8 4 5 6 7 7 8 4 5 6 7 7 8 4 5 6 7 7 8 4 5 6 7
