4 5 7 6 7 5 7 6 5 7 6 5 7 6 5 7 6 5 7 6 5 7 6 5 7 6 5 7 6 5 7 6 5 7
4 5 7 9 19 14 19 22 20 22 22 20 22 21 15 21 20 22 22 20 22 21 20 22 22 20 22 21 20 22 22 20 22 21
4 5 7 6 7 8 2 4 5 7 7 8 2 4 5 5 7 7 8 2 4 5 7 7 8 2 4 8 5 7 6 7 8 8
4 5 6 2 4 5 6 5 6 4 5 6 5 6 4 5 6 5 6 4 5 6 5 6 4 5 6 5 6 4 5 6 5 6 6 5 6 5
4 5 11 7 7 10 10 11 9 10 10 6 7 10 10 11 9 7 10 10 11 8 7 10 10 11 9 7 10 10 11 8 7 10
4 5 9 7 8 11 12 11 5 13 7 8 8 11 12 11 5 13 7 8 8 11 12 11 5 13 7 8 8 11 12 11 5 13
4 9 7 8 8 10 6 9 10 6 5 8 7 10 6 9 10 6 5 8 7 10 6 9 10 6 5 8 7 10 6 9 10 11
4 5 11 11 6 12 12 5 9 8 9 10 10 12 10 10 9 8 9 10 10 12 10 10 9 8 9 10 12 10 10 9 8 9
4 11 7 10 12 7 10 11 13 12 11 13 12 10 11 12 7 10 11 13 12 10 11 12 7 10 11 12 10 11 12 7 11 13
4 9 8 7 6 7 8 5 6 7 8 8 7 6 8 7 6 8 7 6 8 7 8 7 6 8 7 6 8 7 8 7 6 9
4 5 6 8 8 7 6 7 7 8 10 10 9 7 9 7 6 7 8 7 9 10 10 9 7 9 7 6 7 8 9 10 9 11
4 5 6 7 7 6 7 7 7 8 7 8 7 8 7 6 7 7 7 8 7 8 7 6 7 7 7 8 7 8 7 8 8 9
4 5 6 7 6 7 6 7 7 6 7 7 6 7 7 6 7 7 6 7 7 6 7 7 6 7 7 6 7 7 6 7 7 8
4 5 8 5 7 8 5 12 10 8 5 12 10 8 5 12 10 8 5 12 10 8 5 12 10 8 5 12 10 8 5 12 10 13
4 6 4 6 4 6 4 6 4 6 4 6 4 6 4 6 4 6 4 6 4 6 4 6 4 6 4 6 4 6 4 6 4 6 4 6 4 6 4 6 4 6 4 6 4 6 4 6 4 6 4 6 4 6 4 6 4 6 4 6 4 6 4 6 4 6 4 6 4 6 4 6 4 6 4 6 4 6 4 6
4 5 15 16 7 7 7 14 15 16 14 18 11 14 15 16 9 14 15 16 7 14 15 16 14 18 11 14 15 16 14 13 14 19
4 6 6 9 8 9 10 10 11 9 8 9 10 10 11 9 8 9 10 10 11 9 8 9 10 10 11 9 8 9 8 10 10 11
4 6 13 8 11 9 12 7 8 12 17 7 8 12 17 7 8 12 20 19 16 17 7 8 12 9 12 17 7 8 12 20 19 16
4 6 7 8 8 8 7 8 8 5 6 7 7 8 8 8 5 4 6 5 6 7 7 8 8 8 5 6 7 7 8 8 8 8
4 6 6 7 8 8 6 6 7 8 8 6 6 7 8 8 6 6 7 8 8 6 6 7 8 8 6 6 7 8 8 6 6 7 8
4 5 6 6 6 7 5 6 6 6 7 5 6 6 6 7 5 6 6 6 7 5 6 6 6 7 5 6 6 6 7 5 6 6
4 5 5 13 8 10 9 11 9 8 13 9 10 11 9 8 13 10 9 11 10 8 13 10 9 11 10 8 13 10 9 11 10 8
4 5 6 6 4 5 6 5 6 4 5 6 5 6 4 5 6 5 6 4 5 6 5 6 4 5 6 5 6 4 5 6 5 6 4 5 6 5 6 4 5 6 5 6 4 5 6 5 6 4 5 6 5 6 4 5 6 5 6 4 5 6 5 6 4 5 6 5 6 4 5 6 5 6 4 5 6 5 6 4
4 5 21 8 15 22 23 14 20 20 18 21 8 22 23 14 24 17 12 10 21 8 22 23 13 14 10 18 12 21 8 22 23 24
4 5 6 7 12 12 12 7 12 12 12 5 7 12 12 12 5 7 12 12 12 7 12 12 12 7 12 12 12 7 12 12 12 7
4 5 6 7 9 10 6 9 7 10 8 9 7 10 8 9 7 10 8 9 7 10 8 9 7 10 8 9 7 10 8 9 7 10
4 5 11 9 8 9 8 11 9 9 8 11 9 8 9 11 9 8 11 9 8 9 11 9 8 9 11 9 8 9 11 9 8 9
4 5 6 6 7 2 4 5 5 6 6 7 2 4 5 5 6 6 7 2 4 5 5 6 6 7 2 4 5 5 7 6 6 7
4 5 16 7 7 14 15 12 11 19 18 19 13 12 6 13 12 15 12 11 19 18 19 13 12 15 12 11 19 18 19 13 12 15 9
4 5 5 7 5 7 5 7 5 7 5 5 7 5 7 5 7 5 5 7 5 7 5 5 7 5 7 5 5 7 5 7 5 5
4 7 6 7 8 5 8 6 7 7 8 7 8 6 7 7 8 7 8 6 7 7 8 7 8 6 7 7 8 7 8 6 7 7
4 5 6 6 7 7 8 2 4 5 6 5 6 7 7 8 2 4 5 6 5 6 7 7 8 2 4 5 6 5 6 7 7 8
4 5 6 7 8 11 13 9 13 14 11 13 14 12 10 9 14 8 14 13 9 13 14 12 13 14 14 13 14 9 13 14 8 14
4 5 8 6 7 5 8 2 4 5 6 6 8 6 5 8 6 7 2 4 5 6 6 8 6 5 8 6 7 2 4 5 8 6
4 5 11 10 9 8 9 11 10 9 6 11 9 8 9 11 10 9 6 11 9 8 9 11 10 9 6 11 9 8 9 11 10 9
4 5 6 6 6 2 4 5 6 6 6 6 6 6 6 6 6 6 6 6 6 6 6 6 6 6 6 6 6 6 6 6 5 7
4 8 15 13 12 23 24 10 7 25 25 22 24 10 7 25 25 22 24 10 17 25 19 24 10 8 25 25 22 24 10 17 25 19
4 5 6 7 8 7 6 7 8 7 6 7 8 7 6 7 8 7 6 7 8 7 6 7 8 7 6 7 8 7 6 7 8 7
4 5 7 5 7 5 7 5 5 7 5 7 5 7 5 7 5 7 5 7 5 7 5 7 5 7 5 7 5 7 5 7 5 5
4 2 4 2 4 5 4 2 4 5 4 5 4 5 4 5 4 5 4 5 4 5 4 5 4 5 4 5 4 5 4 5 4 5 4 5 4 5 4 5 4 5 4 5 4 5 4 5 4 5 4 5 4 5 4 5 4 5 4 5 4 5 4 5 4 5 4 5 4 5 4 5 4 5 4 5 4 5 4 6
4 7 14 9 23 24 10 21 25 13 10 10 21 17 25 13 10 10 21 21 25 13 10 10 21 12 25 13 10 10 21 21 25 22 10
4 5 6 6 4 5 6 5 6 4 5 6 5 6 4 5 6 5 6 4 5 6 5 6 4 5 6 5 6 4 5 6 5 6 4 5 6 5 6 4 5 6 5 6 4 5 6 5 6 4 5 6 5 6 4 5 6 5 6 4 5 6 5 6 4 5 6 5 6 4 5 6 5 6 4 5 6 5 6 4
4 2 4 5 2 4 5 4 5 4 5 4 5 4 5 4 5 4 5 4 5 4 5 4 5 4 5 4 5 4 5 4 5 4 5 4 5 4 5 4 5 4 5 4 5 4 5 4 5 4 5 4 5 4 5 4 5 4 5 4 5 4 5 4 5 4 5 4 5 4 5 4 5 4 5 4 5 4 5 4
4 5 7 7 6 7 5 7 6 7 6 5 7 6 7 5 7 6 7 6 5 7 6 7 5 7 6 7 6 5 7 6 7 6
4 6 6 7 8 10 11 11 11 6 11 11 6 10 11 11 11 5 11 6 10 11 11 11 6 11 11 6 10 11 11 11 6 11
4 5 7 6 7 6 5 7 6 6 5 7 6 7 6 5 7 6 7 6 5 7 6 6 5 7 6 7 6 5 7 6 7 6
4 5 4 5 4 5 4 5 4 5 4 5 4 5 4 5 4 5 4 5 4 5 4 5 4 5 4 5 4 5 4 5 4 5 4 5 4 5 4 5 4 5 4 5 4 5 4 5 4 5 4 5 4 5 4 5 4 5 4 5 4 5 4 5 4 5 4 5 4 5 4 5 4 5 4 5 4 5 4 5
4 5 6 5 8 6 5 8 6 5 8 6 5 8 6 5 8 6 5 8 6 5 8 6 5 8 6 5 8 6 5 8 6 9
4 5 7 8 7 6 6 6 8 7 8 6 6 6 8 7 8 6 6 6 8 7 8 6 6 6 8 7 8 6 6 8 7 8
4 6 6 6 6 6 6 6 8 9 9 11 8 9 9 11 8 9 10 11 2 4 6 6 6 5 4 6 6 6 6 6 6 8 11
4 9 6 8 7 5 6 8 7 9 6 8 7 5 6 8 7 5 6 8 7 5 6 8 7 5 6 8 7 5 6 8 7 5
4 8 7 8 6 7 8 6 6 7 8 6 6 7 8 6 6 7 8 6 6 7 8 6 6 7 8 6 7 8 6 7 8 6
4 7 6 9 9 7 9 6 9 9 10 8 10 8 10 8 6 7 9 9 6 7 9 9 6 9 5 9 6 9 5 9 8 10
4 5 8 6 7 7 26 23 10 22 28 19 23 25 26 6 16 12 10 22 28 28 19 28 28 19 10 6 16 23 25 26 12 18 28
4 6 2 4 6 5 5 4 6 5 5 4 6 5 5 4 6 5 5 4 6 5 5 4 6 5 5 4 6 5 5 4 6 5 5 4 6 5 5 4 6 5 5 4 6 5 5 4 6 5 5 4 6 5 5 4 6 5 5 4 6 5 5 4 6 5 5 4 6 5 5 4 6 5 5 4 6 5 5 4
4 14 6 7 9 8 10 11 12 13 13 13 15 13 13 15 13 13 15 13 13 15 13 13 15 13 13 15 13 13 15 13 13 15
4 7 7 5 7 7 7 7 7 5 4 7 5 4 7 7 7 7 5 4 7 5 4 7 7 7 7 5 4 7 7 7 7 8
4 5 13 14 8 8 12 6 10 12 12 6 14 12 11 12 6 14 12 13 10 12 11 12 13 14 12 6 10 12 12 6 14 12
4 5 2 4 5 6 4 5 6 5 6 5 6 2 4 5 6 5 6 5 6 2 4 5 5 6 4 5 6 5 6 5 6 7
4 5 9 6 9 10 11 7 11 7 6 9 10 11 7 11 7 6 9 10 11 7 11 7 6 9 11 8 11 9 7 6 11 12
4 5 6 7 8 9 8 7 8 9 8 7 8 8 9 8 7 8 9 8 7 8 9 8 7 8 9 8 7 8 9 8 8 9
4 5 8 9 26 17 18 22 26 25 25 23 26 16 17 18 11 26 25 25 23 26 16 17 18 11 26 25 25 23 26 16 17 18
4 5 5 7 5 7 5 5 7 5 7 5 5 7 5 7 5 5 7 5 7 5 5 7 5 7 5 5 7 5 7 5 7 6
4 5 6 9 10 11 10 7 6 7 6 7 8 8 7 6 10 7 6 10 8 7 6 10 7 6 10 8 7 6 10 7 6 8
4 5 8 7 8 9 12 6 15 10 5 15 7 12 15 6 10 15 10 5 15 7 12 15 6 10 15 10 5 15 7 12 15 6 10
4 5 6 10 11 9 10 6 8 7 9 13 13 13 10 6 8 11 8 10 6 8 7 9 13 13 10 6 8 7 8 8 13 13
4 5 6 6 7 4 5 6 6 6 6 6 6 6 6 6 6 6 6 6 6 6 6 6 6 6 6 6 6 6 6 6 6 6
4 5 6 7 7 6 6 6 6 6 7 6 6 6 7 6 6 6 6 7 6 6 6 6 7 6 6 6 6 7 6 6 6 7
4 6 5 2 4 6 5 5 2 4 6 5 5 2 4 6 5 5 6 5 6 5 6 5 2 4 6 5 5 2 4 6 5 5
4 5 7 5 12 12 10 12 10 10 10 12 10 10 10 12 10 10 10 12 10 10 10 12 10 10 10 10 12 10 10 10 12 12
4 5 7 7 7 6 5 7 6 7 5 7 6 7 5 7 6 7 6 5 7 6 7 5 7 6 7 6 5 7 6 7 5 6
4 5 6 6 4 5 6 6 4 5 6 5 6 4 5 6 5 6 4 5 6 5 6 4 5 6 5 6 4 5 6 6 5 7
4 8 5 9 8 9 5 9 12 12 9 13 2 4 8 5 8 9 5 9 11 13 2 4 8 5 8 9 5 9 11 13 2 4 8 5 8 9 5 9 11 13
4 5 6 6 2 4 5 6 6 6 2 4 5 6 6 6 2 4 5 6 6 6 2 4 5 6 6 6 2 4 5 6 6 6 6
4 8 6 8 9 7 8 9 8 9 7 8 9 8 9 7 8 9 8 9 7 8 9 8 9 7 8 9 8 9 7 8 9 8
4 2 4 5 2 4 5 2 4 5 4 5 2 4 5 2 4 5 4 5 2 4 5 2 4 5 4 5 2 4 5 2 4 5
4 6 7 7 7 7 6 5 7 7 5 7 7 6 7 7 7 6 7 7 7 6 7 7 7 6 5 7 7 5 7 7 7 6
4 5 12 10 6 9 14 14 6 10 9 14 14 8 10 9 14 14 8 10 9 14 14 8 10 9 14 14 8 10 9 14 14 8 10 9 14
4 8 7 7 7 7 8 8 5 4 8 5 4 8 6 4 8 6 4 8 6 4 8 6 4 8 6 4 8 6 4 8 6 4 8 6 4 8 6 4 8 6 4 8 6 4 8 6 4 8 6 4 8 6 4 8 6 4 8 6 4 8 6 4 8 6 4 8 6 4 8 6 4 8 6 4 8 6 4 8
4 5 8 11 5 10 7 5 10 5 10 9 11 11 9 10 7 5 10 5 10 9 11 11 9 10 7 5 10 5 10 5 11 11
4 7 6 7 7 8 4 5 6 7 8 4 5 6 7 8 4 5 6 7 8 4 5 6 7 8 4 5 6 7 8 4 5 6 7 8 4 5 6 7 8 4 5 6 7 8 4 5 6 7 8 4 5 6 7 8 4 5 6 7 8 4 5 6 7 8 4 5 6 7 8 4 5 6 7 8 4 5 6 7
