4 5 6 4 5 6 4 5 6 5 6 7 5 6 5 6 5 6 7 5 6 5 6 5 1 4 5 6 5 6 7 5 6 5 7
4 17 14 7 9 12 19 20 22 22 17 20 22 22 22 20 22 22 22 20 22 22 22 20 22 22 22 20 22 22 22 20 22 22
4 5 7 7 8 5 7 7 8 5 7 7 8 5 7 7 8 5 7 7 8 5 7 7 8 5 7 7 8 5 7 7 7 8
4 5 2 4 5 6 5 6 4 5 6 5 6 5 6 5 6 5 6 5 6 5 6 5 6 2 4 5 5 6 5 6 5 6 5 6 5 6 5 6 5 6 5 6 5 6 5 6 5 6 5 6 5 6 5 6 5 6 5 6 5 6 5 6 5 6 5 6 5 6 5 6 5 6 5 6 5 6 5 6
4 5 5 7 8 6 6 7 6 6 6 7 6 6 6 7 6 6 6 7 6 6 6 7 6 6 6 7 6 6 6 7 6 6
4 5 12 11 8 9 11 6 13 9 11 5 13 9 11 5 13 9 11 5 13 9 11 5 13 9 11 5 13 9 11 5 13 9
4 5 6 7 8 10 11 9 8 10 11 5 8 10 11 5 8 10 11 5 8 10 11 5 8 10 11 5 8 10 11 5 8 10 11
4 13 11 6 12 12 10 9 8 9 10 12 7 8 9 8 9 8 9 8 9 8 9 8 9 8 9 10 12 5 9 8 9 8
4 11 7 10 5 12 13 11 12 13 10 7 5 5 13 12 13 11 13 11 12 13 11 13 11 12 13 11 13 11 12 13 11 13
4 5 6 7 8 9 7 8 5 5 7 8 6 7 8 9 7 8 5 6 7 8 9 7 8 9 6 7 8 5 7 8 9 5
4 5 6 8 6 7 9 10 9 11 9 7 6 8 9 7 9 10 11 9 6 11 9 7 6 8 9 7 9 10 11 9 9 11
4 5 6 7 7 6 8 9 5 8 9 1 4 5 6 5 8 7 6 7 6 8 9 5 8 9 5 8 9 1 5 6 8 9
4 5 6 7 7 8 7 6 7 8 7 7 6 7 8 7 7 6 7 7 8 1 4 5 6 7 7 7 6 7 8 7 7 8
4 5 8 11 7 8 13 11 12 13 11 11 13 11 7 8 11 12 13 11 11 13 11 7 8 11 12 13 11 11 13 11 7 8 13
4 6 2 4 6 2 4 2 4 5 4 2 4 2 4 2 4 2 4 2 4 2 4 2 4 2 4 2 4 2 4 2 4 7
4 5 15 16 8 7 8 17 10 14 15 16 19 13 13 19 5 13 19 10 14 15 16 19 13 13 19 5 12 19 10 14 15 16 19
4 8 9 10 10 11 8 9 10 10 11 8 9 10 10 11 8 9 10 10 11 8 9 10 10 11 8 9 10 10 11 8 9 11
4 6 7 14 9 15 16 17 13 14 12 20 19 6 13 14 12 18 19 6 13 14 12 6 18 19 6 13 14 12 16 17 18 19 6
4 6 7 8 8 8 1 4 6 6 5 6 7 5 6 7 5 6 7 8 8 6 7 5 6 7 8 8 8 1 4 6 6 7 5 6 7 8 8
4 6 6 7 8 5 5 5 7 8 5 5 5 7 8 5 5 5 7 8 5 5 5 7 8 5 5 5 7 8 5 5 5 7 8
4 5 6 1 4 5 7 5 6 7 5 6 7 5 6 2 4 5 5 7 5 7 5 6 7 5 7 5 6 7 5 6 7 5 6 7 5 6 7 5 6
4 5 11 12 13 8 10 10 9 11 12 13 8 10 10 9 11 12 13 8 10 10 9 11 12 13 8 10 10 9 11 12 13 8 9
4 5 2 4 5 6 5 6 4 5 6 5 6 5 6 5 6 5 6 5 6 5 6 5 6 5 6 5 6 5 6 5 6 5 6
4 5 11 12 9 17 21 15 16 15 10 11 19 13 16 15 14 10 11 7 13 16 15 10 11 7 13 16 15 10 11 19 13 16 15 10 11 19 13 16 15 10 11 19 13 16 15 10 6 7 13 16 15 10 11 19 13 16 15 10 11 19 13 16 15 10 11 19 13 16 15 10 11 19 13 16 15 10 11 19
4 5 6 7 12 12 9 7 12 9 9 7 12 5 12 9 7 12 9 9 7 12 5 12 9 7 12 9 9 7 12 5 12 5
4 5 6 10 7 10 7 10 7 10 7 10 5 10 6 7 10 7 10 7 10 7 10 7 10 5 10 6 7 10 7 10 7 5
4 8 11 9 8 11 9 8 1 4 5 11 8 11 9 8 11 9 8 11 9 8 11 9 8 11 9 8 11 9 8 11 9 8
4 5 6 7 5 6 1 4 5 5 2 4 5 5 6 5 2 4 5 5 6 5 2 4 5 5 6 5 2 4 5 5 5 6 6 7
4 8 6 7 7 14 10 16 11 19 11 14 5 19 13 16 11 19 11 14 5 19 13 16 11 19 11 14 5 19 13 16 18 19
4 5 7 8 5 1 4 5 5 7 5 7 8 5 5 1 4 5 5 7 5 7 5 5 7 8 5 1 4 5 5 6 4 5 5 5 7 5 7 8 7 5
4 7 6 5 8 7 1 4 7 6 5 8 7 6 5 8 7 1 4 7 7 8 6 7 8 7 6 5 8 7 1 4 7 7 8 6 5 8
4 5 6 7 1 4 5 6 5 6 7 1 4 5 6 5 6 7 1 4 5 6 5 6 7 8 5 6 7 1 4 5 6 7 8
4 5 6 7 8 9 13 11 12 13 14 14 12 12 8 5 12 9 13 11 12 13 14 12 10 14 5 12 13 11 12 13 14 14
4 5 6 6 5 8 1 2 4 5 6 5 8 6 5 6 8 1 4 5 6 8 5 6 1 4 5 6 5 8 6 5 6 8
4 5 11 8 11 9 11 6 9 11 8 11 9 11 6 9 11 8 11 9 11 6 9 11 8 11 9 11 8 11 9 11 6 10
4 6 5 7 6 7 6 7 5 7 1 4 5 6 5 7 6 6 7 7 6 7 5 7 1 4 5 6 5 7 6 6 5 7
4 8 15 23 10 22 24 10 22 18 21 24 22 15 21 23 25 22 24 21 22 20 21 23 25 22 24 21 22 14 21 23 25 26 24
4 5 6 7 8 7 6 7 8 1 4 5 6 7 8 7 6 7 8 7 6 7 8 1 4 5 6 7 8 7 6 7 8 7 6
4 5 7 5 5 1 4 5 5 7 5 5 7 6 6 6 6 5 1 4 5 5 7 5 5 7 5 6 6 6 6 5 1 4 5 5 7 5 5 7 5
4 6 4 5 4 6 4 2 4 2 4 2 4 2 4 2 4 2 4 2 4 2 4 2 4 2 4 2 4 2 4 2 4 2 4 2 4 2 4 2 4 2 4 2 4 2 4 2 4 2 4 2 4 2 4 2 4 2 4 2 4 2 4 2 4 2 4 2 4 2 4 2 4 2 4 2 4 2 4 2
4 7 14 23 24 17 22 10 24 21 22 14 24 21 13 24 21 22 20 24 21 22 24 21 22 20 24 21 22 24 21 22 20 24 21 22 24 21 22 20 24 21 22 24 21 22 20 24 21 22 24 21 22 20 24 21 22 24 21 22 20 24 21 22 24 21 22 20 24 21 22 24 21 22 20 24 21 22 24 21
4 5 6 2 4 5 6 5 6 5 6 4 5 6 5 6 5 6 5 6 5 6 5 6 5 6 5 6 5 6 5 6 5 6 5 6 5 6 5 6
4 2 4 5 4 2 4 2 4 2 4 2 4 2 4 2 4 2 4 2 4 2 4 2 4 2 4 2 4 2 4 2 4 2 4 2 4 2 4 2 4 2 4 2 4 2 4 2 4 2 4 2 4 2 4 2 4 2 4 2 4 2 4 2 4 2 4 2 4 2 4 2 4 2 4 2 4 2 4 2
4 5 6 7 7 1 2 4 5 7 6 7 7 6 7 5 6 7 1 4 5 7 6 7 7 5 6 7 7 7 1 4 5 7 6 7 7
4 6 5 7 8 10 9 11 6 5 7 8 10 10 11 6 5 7 8 10 10 11 6 5 7 8 10 10 11 6 6 7 8 10 10 11
4 5 6 7 6 7 6 5 1 4 5 6 7 7 6 5 6 7 6 7 1 2 4 5 5 6 7 7 6 7 5 6 7 7
4 5 4 5 4 5 4 5 4 5 4 5 4 5 4 5 4 5 4 5 4 5 4 5 4 5 4 5 4 5 4 5 4 6
4 5 6 7 8 9 7 9 7 5 8 9 6 7 8 9 7 7 9 7 5 8 9 6 7 8 9 7 7 9 7 7 8 9
4 5 6 7 8 6 7 8 6 6 7 8 6 6 7 8 6 5 7 8 6 6 7 8 6 7 8 6 5 7 8 6 5 8
4 6 6 8 11 10 9 10 11 8 10 10 11 11 8 10 9 11 11 8 10 10 11 11 8 10 10 11 11 8 10 10 11 11
4 5 6 8 7 9 5 7 5 7 9 5 7 5 8 9 5 7 5 7 9 5 7 5 8 9 5 7 5 7 9 5 7 5
4 7 8 6 7 8 6 7 8 6 7 8 6 7 8 6 7 8 6 7 8 6 7 8 6 7 8 6 7 8 6 7 8 10
4 5 6 9 9 8 10 6 7 9 8 10 6 5 9 8 10 6 5 9 8 10 6 5 9 8 10 6 5 9 10 8 6 10
4 5 11 14 8 27 20 21 10 25 26 21 17 9 13 14 28 17 12 10 28 17 17 18 28 17 12 10 28 17 17 18 28 17 12 10 28
4 6 1 4 5 4 5 4 5 4 5 4 5 4 5 4 5 4 5 4 5 4 5 4 5 4 5 4 5 4 5 4 5 4 5 4 5 4 5 4 5 4 5 4 5 4 5 4 5 4 5 4 5 4 5 4 5 4 5 4 5 4 5 4 5 4 5 4 5 4 5 4 5 4 5 4 5 4 5 4
4 14 6 9 7 8 9 5 12 13 15 5 11 12 13 15 5 11 12 13 15 5 11 12 13 15 5 11 12 13 15 5 11 12
4 7 2 4 5 4 2 4 5 4 2 4 2 4 5 4 2 4 2 4 5 4 2 4 2 4 5 4 2 4 7 2 4 8
4 5 6 7 8 12 13 10 15 16 8 12 6 7 15 16 8 12 6 7 15 16 8 12 6 7 15 16 8 12 13 7 15 16
4 5 2 4 5 6 5 2 4 5 6 5 6 5 6 5 6 5 6 5 2 4 5 6 5 6 5 6 5 6 5 6 5 6 5 2 4 5 6 5 6 5 6 5 6 5 6 5 6 5 6 5 6 5 2 4 5 6 5 6 5 6 5 6 5 6 5 6 5 6 5 6 5 6 5 6 5 6 5 6
4 5 8 11 7 9 7 9 7 9 7 9 7 9 7 9 8 11 7 9 7 9 7 9 7 9 8 11 7 9 7 9 7 12
4 5 6 9 7 8 9 7 1 4 5 7 9 7 8 9 7 7 8 9 7 1 4 5 7 9 7 7 8 9 7 5 7 8
4 5 17 18 8 9 10 11 12 13 20 22 15 16 17 18 6 20 26 25 26 17 18 15 25 26 25 26 17 18 15 25 26 25 26
4 5 6 7 7 6 7 6 7 6 7 6 7 6 7 6 7 6 7 6 7 6 7 6 7 6 7 6 7 6 7 6 7 6
4 5 9 7 10 9 8 6 8 6 8 11 9 7 6 8 5 8 6 8 11 9 7 6 8 5 8 6 8 11 9 7 6 8
4 5 6 8 9 13 9 8 15 7 11 15 11 15 5 15 5 15 6 10 9 5 15 7 11 15 5 15 6 10 9 5 15 7
4 5 6 11 10 10 13 6 9 13 13 1 4 5 6 11 10 11 10 6 9 13 10 6 7 9 13 13 1 4 5 6 11 10 11 10 5 13
4 5 6 1 4 5 6 7 5 6 2 4 5 5 6 6 2 4 5 5 6 6 2 4 5 5 6 6 2 4 5 5 6 6 5 6
4 6 5 6 7 1 4 5 6 7 5 6 6 6 5 1 4 5 6 7 5 6 6 7 1 4 5 6 7 5 6 6 7 5
4 6 5 1 4 6 5 1 4 6 5 6 2 4 6 5 6 5 1 4 6 5 6 5 1 4 6 5 6 2 4 6 5 6 5
4 5 7 9 10 12 12 5 10 12 5 10 12 9 10 12 5 10 12 5 10 12 5 10 12 5 10 12 5 10 12 5 10 12
4 5 6 7 7 1 4 5 6 7 7 6 7 7 8 5 1 4 5 7 6 7 7 7 8 5 6 7 7 8 5 6 7 7
4 5 6 7 1 4 5 6 5 6 5 6 4 5 6 5 6 5 6 5 6 5 6 5 6 5 6 5 6 5 6 5 6 5 6
4 8 8 12 11 13 8 8 12 13 8 8 12 11 13 8 8 12 11 13 8 8 12 11 13 8 8 12 11 13 8 8 12 13
4 5 6 1 4 5 6 5 1 4 5 6 5 6 5 6 6 5 1 2 4 5 6 5 6 5 6 6 5 1 4 5 6 5 6
4 8 6 7 8 9 8 9 5 8 9 5 7 5 9 5 8 9 5 7 5 9 5 8 9 5 7 5 9 5 8 9 5 7
4 5 2 4 5 2 4 5 2 4 5 2 4 5 2 4 5 2 4 5 2 4 5 2 4 5 2 4 5 2 4 5 2 4 5 2 4 5 2 4 5 2 4 5 2 4 5 2 4 5 2 4 5 2 4 5 2 4 5 2 4 5 2 4 5 2 4 5 2 4 5 2 4 5 2 4 5 2 4 5
4 6 1 4 5 4 5 4 5 4 5 4 5 4 5 4 5 4 5 4 5 4 5 4 5 4 5 4 5 4 5 4 5 4 5 4 5 4 5 4 5 4 5 4 5 4 5 4 5 4 5 4 5 4 5 4 5 4 5 4 5 4 5 4 5 4 5 4 5 4 5 4 5 4 5 4 5 4 5 4
4 5 12 14 9 8 6 14 14 6 8 14 14 8 6 14 14 6 11 14 14 8 8 14 14 8 8 14 14 8 8 14 14 6
4 8 1 4 7 7 7 8 8 8 8 8 1 4 8 7 7 8 8 8 8 8 8 1 4 8 7 7 8 8 8 8 8 8
4 5 8 7 5 10 11 7 9 10 11 9 8 11 5 10 11 7 9 10 11 9 8 11 5 10 11 7 9 10 11 5 8 11
4 7 6 7 7 1 4 7 7 8 4 7 7 8 4 7 7 8 4 7 7 8 4 7 7 8 4 7 7 8 4 7 7 8 4 7 7 8 4 7 7 8 4 7 7 8 4 7 7 8 4 7 7 8 4 7 7 8 4 7 7 8 4 7 7 8 4 7 7 8 4 7 7 8 4 7 7 8 4 7
