4 5 6 4 5 6 4 5 6 5 6 5 6 5 2 4 5 6 5 6 5 6 5 6 5 6 5 6 5 6 5 6 5 7
4 17 12 7 9 19 22 20 22 22 21 22 20 22 22 21 22 20 22 22 21 22 20 22 22 21 22 20 22 22 21 22 20 22
4 5 5 6 7 2 4 6 5 6 6 8 5 6 7 8 5 6 7 8 5 6 7 8 5 6 7 8 5 6 7 8 5 8
4 5 6 2 4 5 6 5 6 5 6 5 6 5 6 5 6 5 6 5 6 5 6 5 6 5 6 5 6 5 6 5 6 5
4 5 6 7 9 10 7 9 6 7 9 6 7 9 10 7 9 10 7 9 6 7 9 10 7 9 6 7 9 10 7 9 6 7 8
4 5 12 11 7 8 13 12 11 5 13 9 9 11 12 11 6 13 13 7 8 9 11 12 11 6 13 13 7 8 9 12 11 5 13
4 5 7 8 10 11 6 8 7 8 10 11 6 8 10 11 5 7 8 10 11 6 8 7 8 10 11 9 8 10 11 6 8 10 11
4 13 11 6 10 12 12 10 12 7 8 9 10 12 12 12 11 8 9 10 12 12 12 11 8 9 10 12 12 12 11 10 9 8
4 11 7 10 11 12 13 11 12 13 5 12 13 5 12 13 5 12 13 5 12 13 5 12 13 5 12 13 5 12 13 5 12 13
4 9 6 7 8 7 8 5 6 9 7 8 5 6 9 7 8 5 6 7 8 5 6 9 7 8 5 6 9 7 8 9 6 7 8
4 5 6 8 7 6 7 9 10 10 9 11 9 6 7 8 9 10 10 9 11 9 7 6 7 9 10 10 11 9 7 6 9 11
4 5 6 7 7 6 8 9 5 8 9 8 9 7 6 7 6 9 5 8 9 5 8 9 5 8 9 7 6 8 9 5 8 9
4 5 6 7 7 8 8 1 2 4 5 6 7 6 7 7 6 7 7 8 5 6 7 8 1 4 5 6 7 7 6 7 8 8
4 5 8 11 7 7 8 10 11 7 5 12 13 11 12 13 11 7 8 11 7 5 7 8 13 11 7 5 12 13 13 11 12 13
4 6 4 6 4 6 4 6 4 6 4 6 4 6 4 6 4 6 4 6 4 6 4 6 4 6 4 6 4 6 4 6 4 6 4 6 4 6 4 6 4 6 4 6 4 6 4 6 4 6 4 6 4 6 4 6 4 6 4 6 4 6 4 6 4 6 4 6 4 6 4 6 4 6 4 6 4 6 4 6
4 5 15 16 8 7 9 10 14 15 16 9 10 12 14 19 5 13 11 12 19 10 14 15 16 9 10 13 14 19 5 12 11 12 19
4 8 9 6 10 9 8 9 10 10 11 9 8 9 10 10 11 8 9 10 9 8 9 10 10 11 9 8 9 10 9 8 10 11
4 6 7 8 9 19 12 7 8 17 9 19 16 17 7 8 12 9 19 16 17 7 8 12 9 19 16 17 7 8 12 9 19 16 17 7 8 12 9 19 16 17 7 8 12 9 19 16 17 7 8 12 9 19 16 17 7 8 12 9 19 16 17 7 8 12 9 19 16 17 7 8 12 9 19 16 17 7 8 12
4 6 7 7 8 8 1 4 6 6 7 5 6 7 6 7 8 8 7 8 1 4 6 6 7 5 6 7 6 7 8 8 7 8
4 6 6 7 8 5 5 5 7 8 5 5 5 7 8 5 5 5 7 8 5 5 5 7 8 5 5 5 7 8 5 5 5 7 8
4 5 6 1 4 5 7 5 6 7 5 7 5 6 7 5 7 5 6 7 5 6 7 5 6 7 5 6 7 5 6 7 5 6
4 12 13 8 10 9 8 10 10 8 13 10 9 8 10 10 8 13 10 9 8 10 10 8 13 10 9 8 10 10 8 13 10 9 8 10 10 8 13 9
4 5 6 2 4 5 5 6 5 6 5 2 4 5 5 6 5 6 5 6 5 6 5 6 5 6 5 6 5 6 5 6 5 6 5 5 6 5
4 5 11 7 8 9 15 17 21 9 10 6 7 24 13 16 15 9 20 6 19 10 21 24 22 23 24 5 14 24 13 10 11 7 8 14
4 9 6 7 12 12 12 9 7 12 12 9 7 12 12 5 7 12 12 5 7 12 12 9 7 12 12 9 7 12 12 9 7 5
4 5 6 9 7 9 7 7 9 7 7 9 7 7 10 7 9 7 7 10 7 9 7 7 10 7 9 7 10 7 9 7 10 7
4 5 8 9 11 9 8 9 11 8 9 11 8 9 8 9 11 8 9 11 8 9 8 9 11 8 8 9 11 8 9 11 9 8
4 5 2 4 5 5 5 2 4 5 5 5 5 2 4 5 5 5 5 6 2 4 5 5 5 5 2 4 5 5 5 5 6 7
4 5 13 7 9 10 14 5 19 5 19 13 14 10 14 5 19 13 7 12 10 14 5 19 13 7 12 10 14 5 19 13 7 12 10
4 8 7 5 7 5 1 4 5 5 5 7 5 7 5 7 5 5 1 4 5 5 5 7 8 7 5 7 5 5 5 1 4 5 5 7 5 7 8
4 7 6 5 8 7 8 7 8 7 8 7 8 7 8 7 8 7 8 7 8 7 8 7 8 7 8 7 8 7 8 7 8 7
4 5 6 7 1 4 5 5 6 5 7 2 4 5 5 6 5 7 2 4 5 5 6 5 7 2 4 5 5 6 5 7 2 4 5 5 6 7 8
4 5 6 7 8 12 9 13 11 12 10 14 12 14 13 11 12 9 13 11 12 10 14 12 8 5 9 13 11 12 14 13 14 14
4 5 8 6 5 8 6 5 8 6 5 8 6 5 8 6 5 8 6 5 8 6 5 8 6 5 8 6 5 8 6 5 8 5
4 5 11 8 9 11 6 9 8 11 9 11 6 9 8 11 9 11 8 9 11 6 10 9 8 11 9 11 6 8 9 11 9 8
4 5 6 7 6 7 7 6 7 7 6 7 6 7 7 6 7 6 7 7 6 7 6 7 7 6 7 6 7 7 6 7 6 7
4 8 15 23 10 19 24 14 21 22 24 21 13 24 21 22 14 24 23 10 22 24 21 13 24 21 13 24 21 23 10 19 24 14 21 22 24 21 13 24 21 23 10 22 24
4 5 6 7 8 7 8 7 6 7 8 7 6 7 8 7 6 7 8 7 6 7 8 7 6 7 8 7 8 7 6 5 8 7
4 5 7 5 5 5 7 5 5 7 5 5 7 5 5 7 5 5 7 5 5 7 5 5 7 5 5 7 5 5 7 5 5 7
4 5 4 2 4 2 4 2 4 2 4 2 4 2 4 2 4 2 4 2 4 2 4 2 4 2 4 2 4 2 4 2 4 2 4 2 4 2 4 2 4 2 4 2 4 2 4 2 4 2 4 2 4 2 4 2 4 2 4 2 4 2 4 2 4 2 4 2 4 2 4 2 4 2 4 2 4 2 4 2
4 7 14 23 24 22 10 24 19 18 24 21 22 24 10 19 24 21 23 24 22 24 10 19 24 21 22 15 24 23 24 22 10 24 19 24 21 22 15 24 23 24 22 10
4 5 2 4 5 6 5 6 5 2 4 5 5 6 5 6 5 6 5 6 5 6 5 6 5 6 5 6 5 6 5 6 5 6 5
4 5 4 5 4 5 4 5 4 2 4 5 4 2 4 5 4 2 4 5 4 2 4 5 4 2 4 5 4 2 4 5 4 2 4 5 4 2 4 5 4 2 4 5 4 2 4 5 4 2 4 5 4 2 4 5 4 2 4 5 4 2 4 5 4 2 4 5 4 2 4 5 4 2 4 5 4 2 4 5
4 5 6 7 7 1 4 5 7 6 7 7 2 4 5 7 7 7 5 6 7 7 1 4 5 7 6 7 7 5 6 7 7 7
4 6 6 7 8 10 10 11 11 6 6 9 10 11 11 6 6 9 10 11 11 6 6 9 10 11 11 6 6 9 10 11 11 6 6 9 10 11
4 5 6 7 2 4 5 5 6 7 6 7 5 1 4 5 5 6 7 6 5 7 1 4 5 6 7 5 6 7 1 4 5 5 6 7
4 5 4 5 4 5 4 5 4 5 4 5 4 5 4 5 4 5 4 5 4 5 4 5 4 5 4 5 4 5 4 5 4 5 4 5 4 5 4 5 4 5 4 5 4 5 4 5 4 5 4 5 4 5 4 5 4 5 4 5 4 5 4 5 4 5 4 5 4 5 4 5 4 5 4 5 4 5 4 5
4 5 6 7 8 8 9 6 7 8 9 7 5 8 9 6 7 8 9 6 7 8 8 9 6 7 8 5 8 9 6 7 8 9
4 5 6 7 8 6 6 7 8 6 6 7 8 6 6 7 8 6 6 7 8 6 6 7 8 6 6 7 8 6 6 5 7 8
4 6 6 8 10 9 10 11 8 9 10 11 11 8 9 10 11 11 8 9 10 11 11 8 9 10 11 11 8 9 10 11 11 8
4 9 6 7 8 7 9 5 8 7 8 5 7 9 8 7 9 8 7 9 8 7 9 8 7 9 8 7 9 8 7 5 8 7
4 7 8 6 7 8 6 7 8 6 7 8 6 7 8 6 7 8 6 7 8 6 7 8 6 7 8 6 7 8 6 7 8 6
4 7 9 6 10 8 5 9 10 8 6 5 9 10 8 6 7 9 10 8 6 7 9 10 8 6 7 9 10 8 6 7 9 10
4 5 11 6 7 8 18 10 22 25 26 12 10 22 17 23 11 26 6 16 10 22 28 23 25 14 6 16 10 22 28 23 25 26 6 16 10 22 28
4 6 2 4 5 2 4 2 4 2 4 2 4 2 4 2 4 2 4 2 4 2 4 2 4 2 4 2 4 2 4 2 4 2 4 2 4 2 4 2 4 2 4 2 4 2 4 2 4 2 4 2 4 2 4 2 4 2 4 2 4 2 4 2 4 2 4 2 4 2 4 2 4 2 4 2 4 2 4 2
4 14 6 7 8 9 6 15 5 11 12 13 15 5 11 12 13 15 5 11 12 13 15 5 11 12 13 15 5 11 12 14 13 15
4 6 4 7 5 4 5 4 5 4 5 4 5 4 5 4 7 5 4 5 4 5 4 5 4 5 4 5 4 5 4 7 7 8
4 5 13 10 11 8 12 13 10 14 11 12 6 14 15 16 16 8 12 13 10 11 12 13 14 15 16 16 8 12 13 10 11 12
4 5 6 7 5 1 4 5 6 5 6 5 2 4 5 6 5 6 5 6 5 6 5 6 5 6 5 6 5 6 5 6 5 7
4 5 10 6 9 7 11 12 11 7 9 10 11 7 9 11 7 9 11 7 9 10 11 7 9 11 7 9 10 11 7 9 11 7 9
4 5 9 7 8 9 7 1 4 5 7 7 9 7 8 9 7 8 5 7 8 9 7 2 4 5 7 7 9 5 7 8 9 7
4 5 17 18 9 22 12 13 14 26 17 18 15 20 26 25 23 20 26 25 26 17 18 24 25 26 25 9 26 17 18 15 20 26 25
4 6 6 7 7 7 6 7 6 7 7 6 7 6 7 7 6 7 6 7 7 6 7 6 7 7 6 7 6 7 7 6 7 5
4 5 9 10 7 11 5 8 6 8 7 11 9 7 5 8 6 8 7 11 9 7 5 8 6 8 7 11 9 7 5 8 6 8
4 5 6 8 9 13 5 15 7 9 14 5 15 7 9 15 12 5 15 7 9 12 5 15 7 9 12 5 15 7 9 12 5 15 7
4 5 6 7 10 11 10 13 6 9 7 10 13 6 9 7 10 13 6 9 7 10 13 6 9 7 10 13 6 9 7 10 13 13
4 5 6 2 4 5 6 5 2 4 5 7 5 6 2 4 5 5 6 7 5 6 5 2 4 5 5 6 2 4 5 5 6 5 6
4 5 6 7 6 6 6 6 7 1 4 5 7 6 7 5 6 6 7 6 6 6 6 6 6 7 5 1 4 5 7 5 6 7
4 6 5 1 4 6 5 6 2 4 6 5 6 5 2 4 6 5 6 5 6 2 4 6 5 6 5 2 4 6 6 5 6 5
4 5 7 5 10 10 12 7 5 10 12 5 10 12 9 10 12 7 9 10 12 1 4 9 14 4 9 14 4 5 14 9 9 10 14 5 7 9 10 10 12 7 5 10 12
4 5 6 7 6 7 8 5 6 7 7 8 5 6 7 7 8 5 1 4 5 6 7 7 8 5 8 5 6 7 7 8 5 6 7
4 5 2 4 5 6 5 6 5 2 4 5 5 6 5 6 5 6 5 6 5 6 5 6 5 6 5 6 5 6 5 6 5 7
4 8 9 12 11 13 13 8 8 12 11 11 13 8 8 12 11 13 13 8 8 12 11 13 13 8 9 12 11 13 13 8 8 12 11 13
4 5 6 2 4 5 6 5 2 4 5 6 5 6 5 6 6 5 1 4 5 6 5 2 4 5 6 5 6 5 6 6 5 6
4 5 6 7 9 8 9 6 7 9 8 9 8 7 9 8 6 7 9 8 9 8 6 7 9 8 9 8 7 9 8 6 7 9
4 5 2 4 5 5 4 5 5 4 5 5 5 4 5 5 5 4 5 5 5 4 5 5 5 4 5 5 5 4 5 5 5 4 5 5 5 4 5 5 5 4 5 5 5 4 5 5 5 4 5 5 5 4 5 5 5 4 5 5 5 4 5 5 5 4 5 5 5 4 5 5 5 4 5 5 5 4 5 5
4 6 2 4 5 4 5 4 5 5 4 5 4 5 4 5 5 4 5 4 2 4 5 4 5 5 4 5 4 5 4 5 5 4 5 4 5 5 4 5 4 5 4 5 5 4 5 4 5 5 4 5 4 5 4 5 5 4 5 4 5 5 4 5 4 5 4 5 5 4 5 4 5 5 4 5 4 5 4 5
4 5 12 14 11 13 14 8 8 13 14 14 8 13 6 14 8 10 14 8 10 14 8 10 14 6 10 14 8 10 14 8 13 14
4 8 7 7 7 7 8 7 8 7 8 7 7 8 7 8 7 8 7 7 8 7 8 7 8 7 7 8 7 8 7 8 7 8
4 9 8 11 7 5 10 11 5 10 11 5 10 11 5 10 11 9 10 11 9 10 11 9 10 11 9 10 11 9 10 11 9 10
4 7 6 7 7 7 1 4 7 7 8 4 7 7 8 4 7 7 8 4 7 7 8 4 7 7 8 4 7 7 8 4 7 7 8 4 7 7 8 4 7 7 8 4 7 7 8 4 7 7 8 4 7 7 8 4 7 7 8 4 7 7 8 4 7 7 8 4 7 7 8 4 7 7 8 4 7 7 8 4
