4 5 7 6 4 5 7 6 4 5 7 7 5 7 5 6 4 5 7 7 5 6 4 5 7 7 5 7 5 6 4 5 7 7
4 5 7 7 19 15 9 19 15 17 20 22 19 22 20 22 22 19 15 5 20 22 22 19 15 5 20 22 22 19 15 5 20 22
4 5 7 7 6 1 4 5 6 7 8 8 2 4 8 5 7 7 8 8 2 4 8 5 7 7 2 4 8 5 7 7 6 8
4 5 6 4 5 5 6 4 5 5 6 4 5 5 6 4 5 5 6 4 5 5 6 4 5 5 6 4 5 5 6 4 5 5 6 4 5 5 6 4 5 5 6 4 5 5 6 4 5 5 6 4 5 5 6 4 5 5 6 4 5 5 6 4 5 5 6 4 5 5 6 4 5 5 6 4 5 5 6 4
4 5 11 7 7 10 8 11 7 10 9 10 11 7 10 9 10 11 7 10 9 10 11 7 10 9 10 11 7 10 9 10 11 7 10 9 10 11 7 10 9 10 11 7 10 9 10 11 7 10 9 10 11 7 10 9 10 11 7 10 9 10 11 7 10 9 10 11 7 10 9 10 11 7 10 9 10 11 7 10
4 5 7 8 9 11 12 11 5 13 7 8 9 11 5 13 9 9 9 11 12 11 5 13 7 8 9 11 5 13 9 9 9 11 12 11 5 13
4 9 7 8 8 10 5 10 5 11 5 7 8 10 5 7 7 8 5 10 11 9 7 7 8 5 10 11 9 7 7 8 10 11
4 5 11 6 6 12 12 5 9 8 9 10 10 12 5 9 8 9 10 10 12 5 9 8 9 10 10 12 5 8 9 9 8 9
4 11 12 12 7 10 11 12 13 12 7 10 11 13 12 12 7 10 11 13 12 12 7 10 11 13 12 12 7 10 11 13 12 12
4 5 8 7 6 7 9 8 7 6 7 9 8 7 6 7 9 8 7 6 7 9 8 7 6 7 9 8 7 6 7 5 8 7
4 5 8 8 7 6 7 5 10 10 10 9 7 5 10 9 7 9 7 5 10 10 9 9 7 5 10 10 9 7 5 10 9 11
4 5 6 7 7 7 6 7 7 5 8 8 8 8 9 5 8 8 8 7 7 5 8 8 8 9 7 7 6 7 7 5 8 9
4 5 6 7 5 6 5 7 5 6 7 5 6 5 7 5 6 7 5 6 5 7 5 6 7 5 6 5 7 5 6 7 5 8
4 5 8 10 7 8 10 10 12 5 10 5 7 8 5 12 10 5 10 5 7 8 5 12 10 5 10 5 7 8 10 10 12 13
4 6 4 6 4 6 4 6 4 6 4 5 4 6 4 6 4 6 4 6 4 6 4 6 4 6 4 6 4 6 4 6 4 6 4 6 4 6 4 6 4 6 4 6 4 6 4 6 4 6 4 6 4 6 4 6 4 6 4 6 4 6 4 6 4 6 4 6 4 6 4 6 4 6 4 6 4 6 4 6
4 5 15 16 7 7 15 16 14 15 16 14 15 16 14 18 13 13 12 19 13 19 5 13 12 19 13 19 14 15 16 14 10 13 12
4 8 9 10 10 2 4 9 7 4 8 9 6 9 8 9 10 10 7 4 9 5 4 9 7 4 8 9 6 9 8 9 10 10 11
4 6 7 14 11 9 12 7 14 17 9 12 6 19 16 17 7 14 17 9 12 6 19 16 17 7 14 17 9 12 6 19 16 17 7 14 17 9 12 6 19
4 6 5 4 6 5 4 6 6 7 5 4 6 6 5 4 6 6 7 5 4 6 6 5 4 6 6 7 5 4 6 6 7 8 8 8
4 6 7 8 8 5 5 7 8 5 6 6 7 8 5 6 6 7 8 5 6 6 7 8 5 6 6 7 8 5 6 6 7 8 5
4 5 6 7 4 5 6 6 7 4 5 5 6 6 7 4 5 5 6 6 7 4 5 5 6 6 7 4 5 5 6 6 7 4 5 5 6 6 7 4 5 5 6 6 7 4 5 5 6 6 7 4 5 5 6 6 7 4 5 5 6 6 7 4 5 5 6 6 7 4 5 5 6 6 7 4 5 5 6 6
4 5 9 8 9 8 11 10 8 13 8 9 10 8 11 10 8 13 8 9 9 8 11 9 8 5 13 8 11 9 8 10 8 13
4 5 6 4 5 5 6 4 5 5 6 4 5 5 6 4 5 5 6 4 5 5 6 4 5 5 6 4 5 5 6 4 5 5 6 4 5 5 6 4 5 5 6 4 5 5 6 4 5 5 6 4 5 5 6 4 5 5 6 4 5 5 6 4 5 5 6 4 5 5 6 4 5 5 6 4 5 5 6 4
4 5 9 8 15 21 10 11 12 10 21 8 14 24 24 5 22 23 24 24 5 14 24 24 5 22 23 24 24 5 14 24 24 5 22 23 24
4 5 7 7 12 12 12 6 7 12 9 7 12 12 6 12 9 7 12 12 6 7 12 5 7 12 12 12 6 7 12 12 6 7
4 5 8 10 7 10 5 8 7 10 5 7 10 5 8 7 10 5 7 10 5 8 7 10 5 7 10 5 8 10 5 7 10 5
4 5 11 8 9 5 11 8 9 5 11 8 9 5 11 8 9 5 11 8 9 5 11 8 9 5 11 8 9 5 11 8 9 5 11
4 5 5 6 6 2 4 5 5 5 6 6 2 4 5 5 5 6 6 6 7 2 4 5 5 5 5 6 6 2 4 5 5 5 6 6 7
4 8 13 7 7 14 6 13 7 9 15 12 5 19 13 7 9 6 13 19 5 7 12 13 6 12 5 19 13 7 12 6 13 19
4 5 7 8 7 8 7 8 7 8 5 7 8 5 7 8 5 7 8 7 8 5 7 8 5 7 8 7 5 7 8 5 7 5
4 7 6 5 8 7 8 7 7 8 5 7 7 8 7 7 8 9 4 7 7 8 6 5 7 8 7 8 7 7 8 7 7 8
4 5 5 6 7 7 7 1 4 5 5 6 5 7 7 5 5 5 6 7 7 2 4 5 5 6 5 7 7 5 5 6 7 7 8
4 5 6 7 8 14 9 13 14 11 13 14 14 12 13 14 11 12 13 14 11 12 13 14 11 12 13 14 11 12 13 14 14 14
4 5 8 6 5 8 6 5 5 8 6 5 5 8 6 5 5 8 6 5 5 8 5 6 5 8 5 6 5 8 5 6 5 8
4 5 11 10 9 8 9 5 11 10 9 8 9 5 11 10 9 8 9 5 11 10 9 8 9 5 11 10 9 8 9 5 11 10
4 5 6 6 5 7 5 7 6 5 6 5 7 6 5 7 6 5 5 7 6 5 6 5 7 6 5 5 7 6 5 6 5 7
4 8 18 9 10 13 24 10 19 24 14 8 25 25 19 24 10 8 25 25 19 24 10 8 25 25 19 24 10 8 25 25 19 24 10 8 25
4 5 6 7 8 7 6 7 5 8 7 5 6 7 5 8 7 5 6 7 5 8 7 5 6 7 5 8 7 5 6 7 5 8
4 5 7 6 7 6 7 6 6 7 6 7 6 7 6 7 6 7 6 7 6 7 6 7 6 7 6 7 6 7 6 7 6 7
4 6 4 5 4 6 4 2 4 2 4 2 4 2 4 2 4 2 4 2 4 2 4 2 4 2 4 2 4 2 4 2 4 2 4 2 4 2 4 2 4 2 4 2 4 2 4 2 4 2 4 2 4 2 4 2 4 2 4 2 4 2 4 2 4 2 4 2 4 2 4 2 4 2 4 2 4 2 4 2
4 7 20 19 13 24 21 21 13 24 21 7 25 25 22 10 21 24 21 9 24 21 7 25 25 22 10 21 24 21 19 24 21 7 25 25
4 5 6 4 5 5 6 4 5 5 6 4 5 5 6 4 5 5 6 4 5 5 6 4 5 5 6 4 5 5 6 4 5 5 6 4 5 5 6 4 5 5 6 4 5 5 6 4 5 5 6 4 5 5 6 4 5 5 6 4 5 5 6 4 5 5 6 4 5 5 6 4 5 5 6 4 5 5 6 4
4 5 4 5 4 5 4 5 4 5 4 5 4 5 4 5 4 5 4 5 4 5 4 5 4 5 4 5 4 5 4 5 4 5 4
4 5 7 7 6 5 6 5 7 5 6 5 6 5 7 5 6 5 6 5 7 5 6 5 6 5 7 5 6 5 6 5 7 5
4 6 6 7 8 9 9 11 11 5 11 6 7 8 9 9 11 11 5 11 6 7 8 9 9 11 11 5 11 6 7 8 9 9 11
4 5 7 6 5 6 5 6 5 6 5 6 5 6 5 6 5 6 5 6 5 6 5 6 5 6 5 6 5 6 5 6 5 7
4 5 4 5 4 5 4 5 4 5 4 5 4 5 4 5 4 5 4 5 4 5 4 5 4 5 4 5 4 5 4 5 4 6
4 5 6 5 8 8 2 4 5 5 8 6 5 8 5 8 5 5 5 8 6 5 5 8 6 5 5 8 6 5 5 8 6 9
4 5 7 6 7 6 5 6 5 7 8 6 5 7 6 5 6 5 7 8 6 5 7 6 5 6 5 7 8 6 5 7 5 8
4 6 6 6 5 4 8 10 10 11 11 2 4 6 6 6 7 4 6 6 6 5 4 6 6 6 6 5 4 6 6 6 6 5 4 6 6 6 6 5 4 6 6 6 6 5 4 6 6 6 6 5 4 6 6 6 6 5 4 6 6 6 6 5 4 6 6 6 6 7 4 6 6 6 6 5 4 6 6 6
4 5 6 8 7 5 8 5 7 5 8 5 7 5 8 5 7 5 8 5 7 5 8 5 7 5 8 5 7 5 8 5 7 5
4 7 8 6 7 8 6 7 8 6 6 7 8 6 7 8 6 7 8 6 7 8 6 7 8 6 7 8 6 7 8 6 7 8 6 7 8 6 7 8 6 7 8 6 7 8 6 7 8 6 7 8 6 7 8 6 7 8 6 7 8 6 7 8 6 7 8 6 7 8 6 7 8 6 7 8 6 7 8 6
4 7 6 9 5 9 6 9 7 8 10 10 10 5 9 6 9 7 8 10 10 10 5 9 6 9 7 8 10 10 10 5 9 6 9 5 8 10
4 5 8 6 7 16 13 26 23 10 22 11 26 9 10 22 5 6 16 22 11 26 9 10 22 16 9 25 14 9 10 22 5 6 16 22 25 14 9 10 22 16 9 25 14 9 10 22 5 6 16 22 25 14 9 10 22 16 9 11 14 9 10 22 5 6 16 22 25 14 9 10 22 16 9 25 14 9 10 22
4 6 5 4 6 5 4 6 5 4 6 5 4 6 5 4 5 4 5 4 5 4 5 4 5 4 5 4 5 4 5 4 5 4 5 4 5 4 5 4 5 4 5 4 5 4 5 4 5 4 5 4 5 4 5 4 5 4 5 4 5 4 5 4 5 4 5 4 5 4 5 4 5 4 5 4 5 4 5 4
4 14 6 9 8 9 6 10 11 12 13 13 13 15 13 13 15 13 13 13 15 13 13 13 15 13 13 15 13 13 15 13 13 15
4 7 5 4 7 5 4 7 5 4 7 5 4 7 5 4 7 5 4 7 5 4 7 5 4 7 5 4 7 5 4 7 5 4 7 5 4 7 5 4 7 5 4 7 5 4 7 5 4 7 5 4 7 5 4 7 5 4 7 5 4 7 5 4 7 5 4 7 5 4 7 5 4 7 5 4 7 5 4 7
4 5 6 14 8 8 12 13 10 12 11 12 13 14 5 15 16 16 16 16 16 5 16 16 16 5 16 16 16 5 16 16 16 5
4 5 6 4 5 5 6 4 5 5 6 4 5 5 6 4 5 5 6 4 5 5 5 6 4 5 5 6 4 5 5 6 4 5 5 5 6 4 5 5 5 7
4 5 9 6 9 10 11 11 7 9 11 5 6 9 11 7 11 7 9 11 7 11 5 6 9 11 11 7 9 7 11 7 11 12
4 5 6 7 8 9 8 6 8 9 8 5 7 8 8 9 8 7 8 8 9 8 5 8 7 8 9 8 5 8 7 8 9 8
4 5 17 18 15 9 13 26 17 18 24 25 19 20 20 26 17 18 16 12 13 26 17 18 24 25 14 20 20 26 17 18 24 25 20
4 5 7 7 6 6 7 6 7 6 7 5 5 7 6 7 5 7 5 7 6 7 5 7 5 7 6 7 5 7 5 7 5 7
4 5 6 7 9 10 7 5 8 8 8 8 11 5 8 8 8 11 7 9 10 5 8 8 8 6 7 5 8 8 8 11 5 8
4 5 6 7 8 9 12 15 6 12 5 7 9 12 15 6 12 8 9 12 5 8 15 9 10 5 8 9 12 15 6 8 9 10 5 8 9 12 15 6 8 9 10 5 8 9 12 15 6 8 9 10 5 8 9 12 15 6 8 9 10 5 8 9 12 15 6 8 9 10 5 8 9 12 15 6 8 9 10 5
4 5 6 10 7 8 5 13 13 13 13 1 4 5 6 10 7 9 5 10 7 8 13 13 2 4 5 5 6 10 7 8 5 13 13
4 5 7 4 5 7 4 5 5 6 7 4 5 5 6 7 4 5 5 6 7 4 5 5 6 7 4 5 5 6 6 5 5 6
4 5 7 6 6 6 5 7 5 6 6 6 5 7 5 6 6 6 5 7 5 6 6 6 5 7 5 6 6 6 5 7 5 6
4 6 5 2 4 6 5 6 5 6 6 6 5 6 6 6 5 6 6 6 5 6 6 6 5 6 6 6 5 6 6 6 5 6
4 9 7 7 9 10 12 12 12 12 10 12 10 12 12 10 12 10 12 12 10 12 10 12 12 10 12 10 12 12 10 12 12 12
4 5 6 7 7 5 6 5 7 7 5 6 5 6 5 7 7 5 6 5 6 5 7 7 5 6 5 6 5 7 7 5 6 5
4 5 6 4 5 5 6 4 5 5 6 4 5 5 6 4 5 5 6 4 5 5 6 4 5 5 6 4 5 5 6 4 5 5 6 4 5 5 6 4 5 5 6 4 5 5 6 4 5 5 6 4 5 5 6 4 5 5 6 4 5 5 6 4 5 5 6 4 5 5 6 4 5 5 6 4 5 5 6 4
4 8 5 11 11 13 13 2 4 8 5 9 8 5 9 12 11 12 1 4 8 5 8 5 8 9 12 11 12 1 4 8 5 9 8 5 9 12 11 13
4 5 6 6 6 5 6 5 6 6 5 6 5 6 6 5 6 5 6 6 5 6 5 6 6 5 6 5 6 6 5 6 5 6
4 8 6 7 9 5 8 9 8 7 5 9 8 7 5 9 8 7 5 9 8 7 5 9 8 7 5 9 8 7 5 9 8 9
4 5 4 5 2 4 5 4 5 5 4 5 5 4 5 5 4 5 5 4 5 5 4 5 5 4 5 5 4 5 5 4 5 5 4
4 6 7 5 4 7 7 5 4 7 7 5 4 7 7 5 4 7 7 7 5 4 7 7 5 4 7 7 7 5 4 7 7 7 5 4 7 7 5 4 7 7 7 5 4 7 7 7 5 4 7 7 7 5 4 7 7 5 4 7 7 5 4 7 7 5 4 7 7 5 4 7 7 5 4 7 7 5 4 7
4 5 12 14 14 14 5 8 5 9 12 14 14 14 5 6 5 10 14 14 14 1 4 5 11 10 9 12 14 14 14 5 5 10
4 7 5 4 8 6 4 8 6 4 8 6 4 8 6 4 8 6 4 8 6 4 8 6 4 8 6 4 8 6 4 8 6 4 8 6 4 8 6 4 8 6 4 8 6 4 8 6 4 8 6 4 8 6 4 8 6 4 8 6 4 8 6 4 8 6 4 8 6 4 8 6 4 8 6 4 8 6 4 8
4 9 8 7 11 6 5 10 5 10 9 5 10 5 10 9 5 10 5 10 9 5 10 5 10 9 5 10 5 10 9 5 10 5
4 7 6 7 8 4 7 5 6 7 8 4 7 5 6 7 8 4 7 5 6 7 8 4 7 5 6 7 8 4 7 5 6 7 8 4 7 5 6 7 8 4 7 5 6 7 8 4 7 5 6 7 8 4 7 5 6 7 8 4 7 5 6 7 8 4 7 5 6 7 8 4 7 5 6 7 8 4 7 7
