4 5 145 139 51 65 66 57 56 58 84 57 22 113 75 52 100 41 54 55 22 36 37 113 124 42 57 58 57 56 8 127 84 127 140 141 141 139 143 141 6
4 5 6 137 11 84 11 123 125 65 99 52 7 87 68 46 15 31 27 84 86 87 88 24 90 71 101 68 24 15 105 50 122 71 74 17 71 41 97 75 99 97 76 117 117 23 74 117 120 122 107 119 120 110 31 125 135 132 133 134 135 119 114 120 98 31 125 65 99 52 137 137 137 8 141 137 6
4 5 34 28 28 14 15 24 6 8 9 13 9 19 20 16 7 34 29 9 21 20 16 29 34 30 9 21 20 16 7 34 30 9 21 20 16 7 34 30 9 21 20 16 7 34 30 9 21 20 16 7 34 30 9 21 20 16 7 34 30 9 21 20 16 7 34 30 9 21 20 16 7 34 30 9 21 20 16 8
4 5 6 95 27 18 87 9 44 39 12 13 14 15 44 17 18 19 20 21 22 28 24 25 26 27 28 29 30 31 45 33 34 35 36 37 38 39 40 41 42 43 44 32 46 122 48 58 50 61 54 62 111 34 110 111 112 113 114 115 19 117 118 119 120 119 5 6 7 27 28 29 30 31 45 80 34 35 36 37
4 5 58 57 10 9 10 21 10 9 15 16 17 18 19 34 21 22 23 24 26 27 28 19 30 31 50 51 32 8 42 43 44 46 47 46 49 28 19 30 43 44 32 31 50 51 38 40 41 42 41 44 46 47 46 47 28 42 41 44 52 52 57 57 56 57 6
4 5 6 7 72 73 87 7 77 8 79 80 12 82 83 84 77 11 12 72 14 91 22 18 68 27 41 42 29 22 16 32 17 34 41 42 104 50 88 49 100 97 25 39 69 100 32 96 102 103 104 50 21 92 93 94 107 108 109 110 111 100 101 102 103 104 50 49 111 23 97 39 96 97 102 103 100 101 102 103
4 5 6 8 19 10 12 16 15 18 18 20 21 16 14 18 15 16 21 23 24 25 25 25 8 29 8 31 23 24 28 28 28 8 29 28 6
4 5 241 16 232 233 16 121 211 100 157 201 131 63 158 159 160 161 162 57 143 218 219 127 147 126 23 157 63 158 159 160 161 162 131 143 218 219 127 146 23 190 188 63 158 159 160 161 162 57 53 54 221 53 49 205 159 160 161 162 131 53 54 221 53 49 157 201 57 53 54 221 162 72 77 46 43 34 130 117
4 5 38 83 9 11 59 13 14 15 16 13 66 19 20 21 22 23 24 25 26 27 28 29 30 30 33 35 34 23 77 54 55 56 57 58 12 65 14 62 63 64 13 18 67 68 69 70 71 72 73 74 75 76 77 54 80 83 83 7 82 80 6
4 5 52 9 8 8 9 10 34 16 10 13 15 16 17 18 21 51 40 23 24 43 44 34 16 11 12 13 14 15 16 17 18 21 26 23 24 8 28 29 30 9 26 23 24 43 44 34 16 11 12 10 17 18 21 22 23 24 8 28 31 29 30 7 40 23 24 43 44 34 16 11 12 10 17 18 21 26 23 24
4 5 6 67 65 8 34 10 21 22 16 21 22 23 32 39 17 62 27 28 61 25 44 14 34 35 55 57 62 51 30 14 46 8 34 10 21 22 23 49 39 17 39 32 44 27 28 25 61 27 28 61 42 61 44 25 26 30 14 52 30 49 17 39 43 32 19 35 27 28 25 61 26 30 14 52 30 49 17 39
4 5 6 6 7 9 9 10 11 12 13 14 15 16 17 18 19 20 22 23 24 25 26 27 28 29 30 31 26 33 10 38 90 27 34 87 88 89 90 93 95 94 49 6 80 81 82 46 84 85 86 87 88 89 90 93 92 94 95 43 101 100 72 73 74 75 77 78 79 80 81 82 46 84 85 86 87 88 89 90
4 5 53 29 49 30 17 11 12 15 33 15 30 17 18 19 20 21 22 23 24 25 26 13 28 49 36 37 11 39 33 34 35 16 37 38 20 21 22 23 24 25 26 15 28 52 49 49 29 51 49 6
4 5 114 107 8 84 10 11 12 13 14 15 81 44 18 19 96 49 91 23 24 25 26 27 28 43 44 17 31 32 33 34 35 36 37 38 39 40 41 42 43 44 45 46 47 48 49 107 51 73 53 54 55 56 57 58 52 60 61 62 63 64 65 66 24 25 69 70 71 72 73 74 75 76 77 78 59 80 16 82
4 5 6 7 29 189 137 32 34 35 36 38 78 43 105 100 107 106 131 132 125 126 127 45 189 31 138 185 198 59 60 61 62 63 64 53 66 67 68 69 70 71 72 73 74 75 76 77 78 79 80 81 82 83 84 85 86 87 88 89 90 91 92 93 94 95 96 97 98 106 100 101 97 103 104 105 99 107 108 109
4 5 113 107 8 9 10 11 12 13 14 15 16 17 18 19 96 50 91 23 68 69 92 27 28 31 45 32 33 34 35 36 37 38 39 40 41 42 43 31 46 47 48 49 50 108 52 60 54 55 56 57 58 59 79 61 62 63 64 65 66 67 68 25 70 71 72 73 76 78 16 82 83 84 85 86 87 88 89 90
4 5 16 15 9 7 16 7 9 15 16 15 9 8 16 15 9 15 16 15 16 15 9 12 15 15 15 14 15 16 16 16 16 16
4 5 6 197 7 99 23 24 25 26 27 28 29 30 31 32 33 34 35 36 37 38 39 40 41 42 43 44 77 78 79 80 81 82 83 84 85 86 87 93 94 90 91 92 88 94 90 96 97 98 99 100 101 102 103 104 105 106 8 108 109 110 111 112 113 114 115 116 117 150 119 120 121 122 123 124 125 126 127 128
4 5 47 7 73 23 7 29 29 29 45 48 46 49 51 42 57 58 46 48 51 49 57 58 60 46 48 46 56 58 57 42 43 30 38 31 57 42 43 30 39 40 41 68 37 66 63 63 73 23 7 29 29 60 45 48 46 49 51 42 57 58 60 31 43 42 57 58 46 44 11 13 63 48 33 55 35 49 67 25
4 5 6 139 10 10 179 339 28 201 158 117 18 128 48 284 94 95 96 97 96 100 101 102 103 218 105 106 198 108 113 110 22 297 298 299 300 301 302 303 304 305 306 307 308 309 310 311 314 314 315 316 317 330 319 320 123 125 124 126 127 128 129 130 131 132 133 134 135 84 137 22 13 139 141 150 143 31 43 44
4 5 6 91 91 59 9 7 59 66 13 36 37 23 51 77 73 23 42 43 44 45 46 47 48 49 76 51 75 36 37 36 34 35 50 23 42 43 44 45 46 47 48 49 76 51 75 36 37 36 34 35 50 23 42 43 44 45 46 47 48 49 76 51 36 37 36 35 23 55 42 43 44 45 46 47 48 49 76 78
4 5 207 204 11 9 7 12 76 14 35 16 27 18 19 21 34 181 148 149 112 165 37 38 39 40 41 42 43 44 25 46 22 48 24 50 204 52 53 170 55 56 57 58 59 121 61 62 63 65 67 68 69 70 89 69 70 89 125 123 124 162 128 129 160 161 130 163 132 155 185 35 166 172 16 121 18 19 21 193
4 5 142 7 8 13 8 160 127 110 111 114 89 105 31 156 167 15 26 17 18 20 19 21 115 44 46 47 120 44 46 50 127 163 52 72 72 73 147 150 147 60 59 57 60 59 57 60 59 57 60 59 57 44 115 46 43 31 32 35 36 108 121 119 21 115 123 120 117 43 121 119 21 123 48 132 110 23 136 157
4 5 92 22 21 42 9 18 45 43 40 29 22 61 36 37 19 18 71 43 44 45 19 18 80 29 27 28 41 42 9 45 43 44 81 82 83 84 85 58 32 26 49 61 36 37 71 71 45 60 56 80 50 25 63 66 39 58 55 74 56 60 56 60 56 52 26 66 80 48 48 48 22 90 48 6
4 5 6 13 21 22 23 24 30 10 16 8 8 17 17 18 7 12 13 13 15 16 13 8 23 15 11 17 18 7 8 13 13 13 7 29 13 31
4 5 6 23 10 107 12 103 58 121 150 48 131 150 157 154 54 91 55 78 84 80 81 78 164 95 163 160 129 35 100 37 97 165 106 11 108 13 143 154 151 103 58 121 66 23 131 150 134 126 93 81 164 162 22 35 98 160 129 161 95 169 89 160 166 67 169 37 160 90 167 167 120 61 151 66 23 25 107 28
4 5 126 53 45 7 98 85 45 53 78 20 80 81 6 83 84 85 86 87 88 89 90 91 92 93 94 95 96 97 78 20 21 81 82 83 84 85 86 87 88 89 90 91 92 93 94 95 96 97 67 10 58 102 101 102 103 104 105 106 107 108 109 110 111 112 113 114 115 116 119 118 119 53 53 53 7 124 7 82
4 5 158 7 32 66 34 68 46 65 33 67 35 141 111 137 143 18 44 99 45 20 53 76 41 40 10 136 79 107 108 39 98 82 86 80 63 20 79 78 65 66 67 35 141 112 137 143 76 59 129 77 99 45 44 89 88 89 144 102 107 136 10 8 102 38 53 76 41 138 139 143 47 111 115 114 113 114 113 47
4 5 74 70 36 37 38 39 53 57 40 11 49 12 13 31 43 54 8 38 48 55 10 67 65 66 67 31 13 9 49 43 56 49 12 43 49 12 43 49 12 43 49 12 43 49 12 43 49 8 47 48 55 10 67 65 66 67 31 13 9 49 43 56 49 12 43 49 12 43 49 12 43 49 12 43 49 12 43 49
4 5 6 8 10 252 120 121 17 128 21 173 22 23 41 212 46 45 185 43 13 114 181 50 36 40 39 40 41 42 43 142 25 46 85 87 112 59 66 17 128 104 127 128 207 63 55 64 59 58 162 60 61 128 122 13 245 246 247 248 10 250 252 12 13 8 29 181 31 174 24 45 26 211 184 172 87 87 112 51
4 5 151 7 47 42 51 64 25 19 142 72 140 117 24 131 23 135 45 7 13 14 129 88 20 74 98 111 76 48 15 51 50 126 138 106 105 134 69 68 24 144 16 17 71 112 47 90 8 111 109 25 61 89 121 72 71 132 134 139 22 131 24 144 19 24 131 138 47 45 9 13 14 129 76 77 75 74 78 103
4 5 26 102 17 18 9 17 20 90 22 23 24 25 26 27 28 29 30 71 63 64 53 54 78 13 38 14 34 41 42 43 44 45 46 13 94 44 43 46 62 60 89 73 19 90 91 92 93 95 95 96 97 98 99 100 101 50 66 13 94 43 42 62 102 59 66 61 62 63 32 65 71 61 62 63 58 65 33 72
4 5 6 7 143 20 149 132 74 137 17 15 140 141 142 137 137 138 139 140 141 142 26 23 50 31 29 30 114 40 91 28 29 30 39 40 166 58 128 52 51 15 141 142 137 138 139 140 141 142 26 23 50 31 29 30 114 40 91 28 29 30 114 165 166 58 128 52 51 15 141 142 137 138 139 140 141 142 26 23
4 5 116 115 36 26 31 23 30 71 35 42 108 109 48 49 35 100 108 109 30 71 29 34 57 79 78 74 17 65 15 10 90 15 70 22 90 73 74 17 65 38 72 71 72 59 50 50 50 52 82 83 83 85 87 96 11 44 58 34 57 79 52 82 83 85 87 103 11 105 81 109 108 109 48 49 52 99 100 108
4 5 6 83 12 12 19 52 66 8 84 22 52 35 33 36 37 19 8 72 20 32 36 41 49 50 33 37 27 42 59 60 66 52 23 55 59 60 42 31 21 41 70 67 47 48 64 67 68 67 68 67 25 26 23 55 59 16 52 66 23 55 81 67 83 83 83 19 92 83 6
4 5 88 7 46 31 32 58 51 50 51 17 76 19 13 14 15 77 55 44 45 80 74 8 9 22 43 34 35 45 41 66 29 60 24 23 29 25 26 27 77 69 56 12 13 14 15 27 11 35 45 54 71 76 19 67 54 68 53 67 54 68 53 67 54 68 53 67 54 68 53 67 54 68 53 67 54 68 53 67
4 5 78 8 61 61 68 67 13 70 37 65 14 15 57 57 64 65 18 19 20 45 65 64 37 13 68 67 70 69 37 22 24 21 57 65 64 65 14 55 65 64 29 13 54 55 65 18 19 20 56 22 21 24 18 19 21 37 8 38 51 40 69 70 67 42 39 44 45 46 20 19 17 20 17 70 69 67 68 24
4 5 6 8 9 66 9 10 11 12 45 16 15 59 60 21 31 68 89 46 101 95 94 76 95 96 97 94 31 65 99 46 38 93 94 96 97 74 98 51 101 102 103 82 83 81 94 26 25 82 18 98 73 95 76 98 30 31 32 62 51 86 13 54 55 40 41 42 43 44 45 51 47 48 49 50 37 52 53 54
4 5 257 15 9 171 172 209 210 211 212 213 214 215 216 217 218 219 73 221 103 104 11 35 50 89 91 92 93 65 64 63 161 136 162 152 210 233 85 199 200 201 202 203 204 205 207 172 209 210 211 212 213 214 215 216 217 218 219 220 221 103 104 11 35 50 89 91 34 93 65 64 63 161 136 162 152 210 233 85
4 5 6 11 11 57 9 9 10 6 53 57 12 20 36 27 37 43 10 30 49 50 8 9 33 34 20 36 45 17 37 23 21 16 44 37 17 16 34 32 21 16 44 12 32 26 43 16 15 23 33 16 53 53 53 11 55 53 57
4 5 6 136 51 52 62 60 77 101 102 75 120 83 30 31 32 34 35 36 135 7 79 80 41 48 66 67 68 69 70 71 135 73 74 75 103 132 133 134 8 8 8 7 140 8 142
4 5 55 9 8 39 38 15 15 18 19 20 20 35 43 47 48 7 23 24 31 14 10 44 25 14 30 31 18 19 43 47 35 43 50 21 21 9 53 21 6
4 5 6 58 61 25 26 27 8 9 10 10 11 13 14 15 26 27 17 18 19 20 21 22 23 24 25 26 27 28 29 30 31 41 42 43 44 45 46 47 48 49 50 51 52 53 54 55 56 57 58 58 58 7 62 61 11
4 5 6 7 15 16 11 12 13 14 15 16 16 77 24 71 13 36 48 42 31 16 15 16 77 41 18 19 20 84 22 23 8 7 50 33 37 39 40 41 17 18 19 20 22 23 84 22 23 8 8 32 33 37 39 40 41 17 38 44 45 36 59 37 39 40 41 17 80 56 42 80 82 57 38 41 17 38 44 36
4 5 6 7 189 56 145 146 146 147 148 149 114 115 152 153 154 58 156 157 158 159 160 161 162 201 164 165 166 167 168 169 170 171 172 173 174 175 110 177 178 179 180 181 182 183 184 185 186 187 188 189 114 191 192 193 194 195 196 197 198 199 200 201 58 203 204 205 206 207 208 209 210 211 212 127 214 7 215 216
4 5 231 228 227 231 28 227 135 27 28 88 164 227 6 27 137 31 133 8 36 95 97 98 109 149 117 13 21 121 18 37 11 28 88 164 226 47 209 110 219 142 121 67 109 110 199 207 125 20 44 31 138 44 138 139 172 84 148 18 25 36 19 57 63 165 119 71 170 120 133 172 20 87 23 186 47 223 24 227
4 5 6 73 61 33 63 65 31 65 54 67 70 60 48 21 74 17 27 28 36 37 17 51 28 36 37 70 60 48 48 13 46 35 60 59 35 60 59 35 60 59 47 60 59 35 60 59 35 60 59 35 60 59 60 48 13 34 47 60 59 60 48 13 46 47 60 59 60 48 13 34 47 60 59 60 48 13 46 47
4 5 6 7 269 15 72 78 219 149 174 175 176 177 178 180 181 182 183 184 21 186 187 188 194 190 191 192 21 194 195 196 197 198 199 200 201 202 203 204 205 206 207 208 209 210 211 212 213 142 142 237 238 239 240 241 242 243 244 245 246 247 248 249 250 251 252 258 254 255 256 257 258 259 260 261 262 169 264 265
4 5 333 7 69 11 12 13 14 230 44 45 46 47 50 48 44 45 46 42 43 54 52 50 78 52 313 79 287 288 82 143 84 292 86 87 16 47 91 324 329 7 93 205 95 96 97 98 53 308 309 310 311 21 313 314 315 145 317 68 242 243 98 277 278 125 126 127 128 129 130 131 132 133 134 135 136 137 138 139
4 5 294 293 234 9 10 231 12 13 14 15 16 17 18 19 20 21 29 31 30 25 26 27 28 217 216 23 32 33 34 36 36 37 38 39 40 217 42 42 43 44 45 46 47 48 49 50 51 52 130 54 55 56 57 58 59 264 265 266 267 268 269 270 271 272 273 274 275 276 277 278 279 280 103 282 283 284 285 286
4 5 6 72 38 34 65 41 22 18 19 20 21 43 23 25 26 27 28 29 30 27 28 29 30 71 72 72 72 33 76 72 78 37 38 34 65 41 42 19 20 21 25 26 27 28 29 30 71 72 72 72 33 76 72 78
4 5 137 133 8 72 10 74 12 13 14 15 26 17 133 129 129 133 20 21 45 46 24 25 20 27 28 29 30 31 32 33 34 35 36 37 38 39 40 41 42 43 44 22 46 47 48 49 50 51 52 53 54 55 56 57 58 59 60 61 62 63 64 65 66 67 68 69 20 17 72 10 74 75 76 77 78 79 80 81
4 5 57 7 34 30 36 9 8 37 19 8 17 14 48 12 37 8 48 16 17 38 40 39 40 39 20 21 22 23 35 36 26 27 28 29 29 32 33 7 34 30 25 20 47 28 29 24 31 37 8 38 40 39 40 39 20 21 22 23 35 36 26 27 28 29 29 32 33 51 51 51 7 55 51 57
4 5 6 7 7 6 8 8 8 7 13 8 6 15 7 6 14 14 6 9 13 10 6 15 7 6 10 8 8 7 13 7 15 15
4 5 6 33 8 213 10 11 12 13 14 15 16 17 17 72 13 172 49 17 173 172 187 176 17 171 135 166 167 168 63 103 52 96 9 212 142 231 229 223 224 110 232 226 228 229 223 224 110 103 251 189 106 226 228 229 230 231 232 88 51 170 236 7 34 178 112 45 171 183 173 51 87 187 90 111 55 199 58 166
4 5 6 8 10 11 66 21 84 46 63 88 89 90 91 92 91 92 91 13 97 8 24 57 26 28 96 39 40 41 42 96 34 43 44 45 14 47 48 49 50 51 52 53 54 55 56 57 27 96 94 39 34 40 41 42 43 44 45 46 47 48 49 50 51 52 53 54 55 56 25 59 60 61 62 63 64 65 66 67
4 5 59 53 10 9 10 20 10 9 14 15 16 17 28 19 20 21 22 23 25 26 27 11 29 30 31 50 51 37 40 41 42 43 44 46 47 46 56 30 50 51 37 31 30 42 43 44 46 47 46 38 16 38 24 51 50 31 30 37 40 41 42 43 44 46 47 46 47 42 41 30 50 51 37 31 30 37 50 51
4 5 6 50 51 186 103 60 54 55 56 27 91 71 90 67 175 66 176 178 83 84 17 176 72 73 64 171 61 62 51 186 53 138 139 140 142 175 66 85 40 89 41 104 195 197 86 192 149 174 179 100 29 79 83 184 177 160 161 162 218 189 100 205 154 74 149 75 80 131 132 142 157 95 191 162 41 184 177 171
4 5 273 270 10 11 12 17 53 15 11 16 13 52 108 109 29 127 96 97 98 195 196 216 214 213 217 212 218 257 252 259 260 145 62 229 146 147 150 24 201 65 12 67 198 38 186 179 77 181 164 165 42 20 35 103 102 138 179 77 181 87 87 171 201 82 84 43 236 246 85 56 143 140 233 158 73 192 145 40
4 5 284 7 238 8 63 17 63 75 123 74 260 276 10 260 222 63 17 222 63 17 222 63 17 222 63 17 222 63 11 222 248 15 262 139 140 243 31 109 108 32 33 39 40 46 47 263 50 126 131 156 118 63 222 135 171 38 250 126 128 129 130 125 103 45 183 184 47 40 151 124 125 50 126 144 117 225 66 235
4 5 6 7 28 29 35 20 17 28 29 30 36 18 19 20 20 17 29 35 20 17 58 33 29 30 20 17 58 33 41 30 36 18 19 20 20 17 11 12 10 16 37 39 22 57 56 24 11 23 16 12 11 37 51 56 37 38 39 20 26 28 29 42 12 10 16 52 19 36 57 56 37 11 12 10 37 39 38 19
4 5 229 223 51 197 102 60 54 55 56 90 164 9 165 71 22 66 149 85 40 41 84 23 173 65 66 149 132 86 179 154 95 178 79 96 177 176 91 92 19 85 96 73 129 63 61 62 51 197 53 104 105 55 24 98 165 90 9 96 21 97 61 106 37 34 70 138 139 141 23 66 149 85 65 179 180 154 157 158
4 5 40 7 8 9 10 11 30 12 8 9 10 24 18 17 27 19 24 21 21 11 12 25 14 30 14 12 25 24 21 30 25 9 10 24 21 21 19 9 10 24 23 21 21 15 25 12 11 14 30 36 9 10 24 21 21 19 25 27 24 24 19 37 37 34 25 38 37 6
4 5 176 72 65 81 85 83 37 145 136 25 32 30 31 29 33 25 101 37 38 39 40 41 42 51 44 45 46 47 48 9 164 43 52 21 54 55 56 57 58 59 60 61 62 63 64 65 66 67 149 69 69 73 49 75 76 73 14 75 79 80 81 82 83 85 82 86 87 88 89 90 91 92 93 95 96 79 82 80
4 5 6 8 21 19 62 59 67 61 101 96 13 54 40 43 85 45 85 40 43 27 80 40 43 44 46 45 85 91 83 27 80 40 43 99 98 54 30 31 47 59 101 96 39 87 69 70 37 77 78 21 83 85 40 43 46 28 80 42 43 33 45 80 91 92 93 90 95 97 44 95 29 54 36 52 70 87 38 36
4 5 6 72 8 10 24 12 35 36 37 38 39 40 41 42 43 44 45 46 47 48 49 50 51 52 53 54 55 10 32 59 65 66 67 27 48 46 56 49 50 48 32 59 20 61 18 19 13 14 15 16 31 30 29 40 66 67 53 66 45 69 72 72 72 22 74 72 76
4 5 66 108 69 14 18 75 76 77 78 79 80 81 40 83 84 85 86 87 88 30 90 91 23 93 94 95 37 97 98 99 100 101 102 103 104 105 106 107 8 109
4 5 130 129 7 9 118 12 15 81 11 54 16 20 21 50 22 24 29 15 11 54 16 17 35 36 13 14 29 15 18 21 22 50 24 29 63 74 69 11 12 36 13 14 16 15 17 18 21 22 50 51 24 29 103 78 79 80 107 106 44 72 106 102 54 56 55 56 55 56 116 56 116 56 90 91 84 107 90 91
4 5 71 65 65 9 62 11 15 24 11 24 63 14 17 41 17 58 31 54 31 44 40 30 54 40 44 20 21 41 17 52 64 44 50 9 24 63 17 55 52 64 50 53 18 40 44 50 49 54 31 21 41 15 20 21 52 64 44 50 52 35 20 21 18 40 52 64 44 56 35 53 18 40 59 29 49 44 50 52
4 5 141 135 20 19 125 28 126 10 85 83 41 47 23 22 23 128 123 40 48 27 109 36 130 85 102 73 73 130 13 128 105 130 36 14 37 38 67 97 98 125 54 53 82 83 84 47 41 124 56 85 110 60 83 31 47 125 53 99 39 32 21 41 124 56 85 52 32 110 108 40 23 128 101 69 27 28 50 123
4 5 6 7 8 86 10 11 12 13 14 15 16 45 18 19 20 51 93 23 69 70 26 27 28 45 31 32 33 34 35 36 37 38 39 40 41 42 43 45 46 46 50 7 53 75 55 56 57 58 59 60 80 62 63 64 65 66 67 68 24 25 71 72 73 74 77 79 16 84 85 9 87 88 89 90 91 92 93 26
4 5 6 8 31 47 33 77 43 42 134 71 72 69 67 83 90 101 99 97 102 98 100 98 97 139 115 116 114 139 114 142 140 140 118 142 82 31 46 32 48 72 21 22 129 84 85 90 86 89 97 99 101 36 98 53 113 17 76 114 139 115 116 116 114 142 140 140 118 140 120 82 76 46 32 48 72 21 22 67
4 119 104 251 76 177 187 188 189 190 192 193 192 171 50 59 23 49 155 156 208 216 219 171 23 18 23 52 50 61 62 63 64 64 15 73 175 157 19 163 161 143 212 145 141 139 148 149 150 151 152 153 154 155 156 208 216 219 171 165 215 248 193 192 193 192 50 23 52 50 61 62 63 64 64 15 73 175 157 175
4 5 70 31 16 61 33 34 58 16 17 18 19 20 21 22 23 24 24 62 63 23 62 63 19 17 18 19 20 21 22 23 24 62 63 19 29 30 18 63 33 34 44 50 21 22 49 52 51 37 47 55 53 46 21 22 49 52 51 63 57 58 15 62 63 62 63 19 29 30 18 63 27 46 22 49 52 32 32 32
4 5 6 50 25 36 27 28 30 29 34 11 36 13 46 40 41 39 17 30 33 34 32 15 40 19 17 18 19 50 50 50 49 53 50 55
4 5 57 9 16 17 18 30 17 34 10 13 34 47 11 32 15 46 10 11 52 12 33 14 30 13 34 52 12 13 14 30 49 32 30 49 10 52 47 47 9 55 47 57
4 5 6 29 65 38 39 18 33 74 56 21 35 34 54 22 56 53 79 51 77 50 23 52 75 78 49 51 71 72 75 74 15 52 56 53 22 78 49 54 51 77 77 50 51 52 75 23 42 45 75 22 46 13 14 57 48 79 51 77 50 51 77 23 52 75 75 42 45 75 55 46 57 53 25 51 77 50 77 51
4 5 7 95 85 36 16 38 34 31 81 32 37 38 51 42 31 81 34 33 41 65 35 42 42 51 83 65 79 50 51 80 81 31 34 33 70 49 42 18 35 65 83 24 50 51 80 81 34 31 33 70 33 41 81 31 32 85 85 85 52 98 85 100
4 5 6 50 50 208 167 86 87 180 139 122 17 130 131 132 185 134 225 209 82 52 53 58 59 55 56 164 54 73 93 72 197 173 174 167 166 232 70 73 39 31 104 80 191 33 56 58 59 13 102 72 107 160 173 174 197 45 232 71 216 220 31 156 104 191 122 134 225 211 211 147 134 136 105 103 169 166 167 166
4 5 81 27 36 37 38 39 12 13 14 15 16 17 18 19 20 32 22 23 24 25 26 27 47 71 71 71 32 22 34 35 28 48 10 39 40 41 42 43 44 45 46 27 37 10 50 51 52 53 54 55 56 57 58 59 60 61 62 63 64 65 66 67 68 69 70 31 29 72 27 27 27 27 78 79 27 6
4 5 6 8 69 11 12 13 301 41 44 45 46 42 43 54 40 50 43 44 45 46 89 43 54 40 50 43 44 45 46 47 43 54 40 50 295 49 311 54 55 117 179 106 58 59 60 61 62 63 64 65 66 67 53 69 185 71 72 73 281 25 22 161 104 162 163 164 165 166 167 168 169 170 171 172 173 174 175 176
4 5 6 134 9 9 136 88 89 101 116 108 29 30 114 45 35 33 34 35 36 37 26 29 36 64 117 12 52 10 15 30 17 77 19 79 21 22 23 129 37 123 124 26 33 34 108 55 89 44 30 114 115 116 50 11 118 52 53 54 56 57 58 73 74 77 79 71 72 73 74 73 46 114 30 79 21 77 76 80
4 5 124 7 75 11 84 13 21 15 16 53 18 19 70 100 84 21 22 23 24 25 26 27 28 29 30 77 20 108 34 35 36 37 107 39 40 41 42 43 44 45 46 47 48 49 50 51 16 17 54 74 56 92 58 59 60 61 62 63 64 65 66 67 68 69 70 71 72 73 55 75 116 77 84 102 81 82 31 20
4 5 6 47 48 49 41 98 30 95 96 97 98 68 36 130 17 19 128 53 15 126 24 82 83 106 108 108 80 152 108 133 79 83 110 106 108 108 89 36 95 96 97 51 68 130 17 18 128 19 53 15 23 24 89 61 138 138 58 15 23 89 141 97 143 68 30 31 127 91 54 55 58 15 23 24 82 83 106 108
4 5 203 198 198 99 22 23 68 25 26 27 28 191 30 31 32 165 34 35 36 37 38 39 40 41 42 43 77 78 79 80 81 82 83 91 85 86 87 88 94 95 91 92 93 94 95 96 97 98 63 100 101 102 103 104 105 107 108 109 106 54 55 120 115 116 117 118 72 120 121 122 123 124 125 126 17 128 129 130
4 5 178 64 12 47 14 45 148 16 17 14 80 84 120 22 61 25 76 77 41 70 83 140 80 145 149 148 151 150 64 121 17 19 139 131 85 84 124 26 40 69 41 140 83 140 83 140 149 148 151 105 30 61 87 88 21 165 58 167 169 170 171 64 64 64 7 176 64 178
4 5 6 52 26 14 15 61 13 14 15 16 83 42 107 109 110 109 112 96 26 103 82 43 99 100 57 102 31 32 33 34 35 36 57 38 39 40 56 73 43 29 115 80 50 60 61 62 107 99 99 102 51 28 30 44 80 115 80 115 116 117 94 119 84 92 105 106 107 108 27 17 18 19 20 16 83 21 114 80
4 5 61 57 8 8 17 26 34 10 24 22 21 22 15 8 58 44 32 37 36 49 35 38 39 29 43 44 32 46 13 51 52 37 38 39 9 16 46 52 43 44 32 35 51 13 51 52 19 40 23 53 19 52 19 40 15 35 31 45 11 13 51 10 24 22 21 22 24 15 21 22 24 15 13 51 52 37 41 9
4 5 222 216 11 147 150 108 37 14 158 147 150 77 115 142 137 55 200 85 96 88 159 144 126 198 197 36 85 49 133 105 158 135 106 134 105 10 158 147 150 108 37 14 34 158 147 150 21 91 60 130 116 75 76 49 33 72 28 29 160 64 116 34 68 49 133 134 105 135 136 142 138 137 55 141 146 153 59 154
4 10 11 203 148 35 147 20 21 22 125 124 103 25 41 129 63 192 193 45 5 6 7 8 7 14 194 195 107 14 172 171 72 74 61 168 63 64 65 66 67 68 69 70 71 72 60 42 75 54 55 50 57 58 59 37 61 168 63 64 65 66 67 68 69 70 71 72 74 42 18 54 55 50 57 58 59 37 61 168
4 5 6 7 8 9 16 11 12 13 14 35 38 17 90 19 20 21 22 23 24 25 26 27 28 116 30 31 86 33 34 35 36 37 48 39 40 41 42 43 44 45 46 47 48 39 50 51 52 53 54 55 56 57 58 59 60 61 62 63 64 65 145 67 68 69 70 71 72 73 74 38 76 77 78 79 80 81 82 83
4 5 116 111 63 64 94 72 67 74 78 70 64 65 66 89 88 79 21 89 103 99 98 74 74 74 85 99 32 17 56 88 58 94 66 75 45 46 108 109 20 21 15 34 34 92 61 110 110 110 7 114 110 6
4 5 6 73 8 116 116 12 11 15 114 17 18 19 36 72 33 67 87 88 19 33 67 93 119 120 119 120 101 77 71 92 95 95 17 18 72 93 33 62 87 88 33 67 64 66 87 88 19 33 67 87 88 33 67 64 66 87 88 33 67 64 87 88 33 67 64 66 87 88 33 67 64 87 88 33 67 64 66 87
4 5 23 117 60 81 87 69 84 115 82 83 85 86 17 60 110 97 90 88 98 93 90 88 98 115 93 43 78 41 42 32 29 115 114 119 25 44 12 103 21 19 107 18 43 50 51 81 87 67 66 39 79 37 11 51 53 98 37 47 81 82 83 84 85 86 69 105 115 71 118 72 44 24 75 37 79 28 103 67
4 5 6 185 8 9 48 11 50 13 14 15 16 68 18 19 40 42 22 23 53 170 30 132 31 32 33 28 35 36 39 38 39 160 41 42 42 44 45 46 97 48 49 12 51 52 24 54 55 56 57 58 59 60 61 62 63 64 65 66 15 68 69 70 71 72 44 74 30 77 78 79 80 81 82 83 84 85 86 87
4 5 6 7 10 10 29 105 67 72 8 28 31 68 94 35 46 42 60 61 62 64 43 41 40 41 98 35 28 20 65 14 98 35 36 63 43 62 73 64 73 91 73 43 67 39 100 72 99 100 69 70 65 14 98 41 37 50 108 88 56 87 20 98 64 62 43 73 64 73 91 73 63 91 42 73 64 91 40 39
4 5 6 67 14 14 41 33 40 32 63 41 44 33 40 44 39 32 63 41 17 19 56 36 58 17 18 39 51 50 16 32 33 40 63 41 47 42 19 18 42 39 51 50 61 33 32 63 40 63 32 44 49 30 39 63 32 33 40 44 63 17 19 21 18 42 39 51 50 16 32 63 40 32 63 41 44 33 40 44
4 5 63 58 8 9 10 11 13 46 15 16 17 18 19 20 21 22 23 26 24 27 47 14 38 45 58 30 31 32 44 34 35 36 37 44 39 50 43 38 34 40 22 41 42 41 13 16 14 15 10 19 21 22 23 26 11 12 13 14 15 16 17 25 19 20 21 22 23 26 24 27 47 14 58 58 58 57 61 58
4 5 11 7 8 46 27 39 38 33 29 23 30 18 19 20 29 24 34 25 36 18 19 20 39 38 27 13 14 30 28 19 20 38 39 38 33 27 39 38 38 34 35 36 44 42 19 20 18 42 38 39 27 44 42 19 20 18 35 36 39 38 44 33 40 18 20 19 21 38 39 38 42 39 17 33 40 19 18 20
4 5 35 92 50 51 11 58 54 78 76 80 81 51 57 83 84 85 86 57 12 89 90 91 92 92 92 92 96 92 98 36 29 54 34 24 42 43 44 45 46 47 48 49 50 51 57 58 59 60 61 62 21 54 65 92 92 92 80 96 92 98
4 10 183 70 29 28 20 15 146 17 18 67 14 22 100 23 24 25 102 26 127 128 166 167 114 169 170 171 70 77 174 33 34 28 61 142 82 74 133 134 135 17 69 79 80 81 38 12 97 31 99 101 100 23 24 25 102 158 100 22 101 149 71 88 71 162 112 88 139 140 34 132 110 22 115 155 24 23 129 127
4 5 6 45 25 31 29 30 41 16 47 46 9 10 11 20 9 18 11 21 38 14 13 20 18 19 38 49 9 10 19 14 13 36 36 36 7 48 36 50
4 5 367 8 69 11 12 13 259 48 44 45 46 47 48 54 49 50 229 44 45 46 89 48 54 49 50 15 44 45 46 47 48 54 49 50 78 40 347 54 55 117 118 58 32 59 60 61 62 63 64 65 66 67 53 69 187 71 72 73 8 107 22 163 23 164 165 166 167 168 169 170 323 23 105 106 25 108 109 110
4 5 126 7 11 11 14 18 20 19 30 100 18 69 43 15 111 12 113 119 100 109 135 93 136 22 23 15 134 120 12 85 12 113 46 45 25 38 49 40 62 63 130 88 48 32 50 24 63 62 91 107 108 102 103 75 97 12 33 119 100 107 108 102 103 25 97 32 99 30 18 23 22 22 100 119 100 79 80 81
4 5 113 107 8 84 10 11 12 13 14 15 16 45 18 19 20 21 91 23 24 69 26 27 28 45 31 32 33 34 35 36 37 38 39 40 41 42 43 17 46 47 48 49 21 7 52 60 54 55 56 57 58 59 53 61 62 63 64 65 66 67 24 25 70 71 72 73 76 78 16 82 83 9 85 86 87 88 89 90
4 5 59 7 8 8 10 12 13 14 15 15 36 20 31 32 33 19 47 36 35 34 15 21 22 23 24 7 28 49 30 51 15 36 34 35 48 22 9 28 49 30 32 31 19 47 36 35 34 41 40 41 40 41 40 29 50 51 15 51 15 12 17 13 14 15 18 41 40 41 51 45 36 35 34 15 21 22 18 41
4 5 6 50 24 11 20 47 44 45 44 24 18 12 32 47 44 45 34 35 35 32 34 30 32 35 45 44 45 9 27 9 10 16 17 34 35 35 45 44 45 44 45 34 35 10 10 10 8 56 50 58
4 5 6 7 8 49 21 33 12 13 14 15 16 17 18 23 26 25 24 27 28 29 26 25 24 27 28 29 67 31 40 33 46 20 40 41 35 44 34 35 36 37 38 39 42 43 44 46 47 48 31 32 51 52 53 54 55 56 57 58 59 60 61 62 63 65 65 65 7 68 65 70
4 5 112 108 8 9 10 11 12 13 14 15 80 17 18 19 20 21 22 23 67 68 91 27 28 17 30 31 32 33 34 35 36 37 38 39 40 41 42 17 45 46 47 48 21 109 51 52 53 54 55 56 57 58 52 60 61 62 63 64 65 66 67 68 69 70 71 72 73 74 75 76 77 73 79 80 81 82 9 84
4 5 121 117 41 91 42 70 37 63 29 102 103 103 104 94 55 35 36 37 38 70 114 111 83 41 41 66 84 43 44 88 47 48 110 23 24 25 110 17 22 20 21 23 109 25 26 28 29 64 27 48 30 56 57 58 30 67 102 103 104 94 71 35 36 37 38 70 41 71 94 77 70 111 75 41 71 22 57 58
4 5 8 8 14 10 17 19 42 26 27 28 7 33 34 35 40 8 33 21 22 23 25 26 27 28 7 33 34 22 26 27 28 8 43
4 5 168 129 129 44 31 46 96 28 34 44 45 32 79 45 46 18 19 20 149 22 34 49 145 146 136 52 158 26 135 114 116 57 104 8 9 52 138 69 114 116 107 25 28 34 136 79 20 18 19 25 34 96 28 34 87 44 81 32 79 20 141 18 145 14 144 71 39 149 150 152 64 158 144 145 147 144 14 148
4 5 69 62 60 60 8 35 11 12 38 52 53 54 55 51 21 47 13 56 56 37 54 55 56 56 56 37 54 55 56 56 37 54 55 56 56 47 13 21 47 19 49 50 51 21 47 43 12 38 52 53 54 55 51 21 47 13 18 50 21 47 52 53 54 55 51 21 47 13 18 28 49 50 42 42 63 63 63 63
4 5 6 83 8 42 20 27 28 50 10 11 12 45 8 14 15 72 26 21 22 56 53 54 23 24 27 22 44 29 58 55 54 53 56 58 38 65 64 65 11 12 60 11 12 46 13 46 81 59 35 60 59 9 31 30 36 37 60 56 23 24 55 58 56 53 54 53 61 35 60 35 36 41 42 43 38 64 17 67
4 5 6 7 8 9 7 36 12 11 35 62 64 65 9 77 46 47 48 49 50 39 25 30 31 29 32 36 11 35 57 56 87 57 106 50 39 25 79 108 29 32 36 11 35 57 56 87 49 50 39 29 79 108 32 36 11 35 33 37 45 79 80 11 38 51 41 108 29 32 36 11 35 57 56 14 63 25 79 108
4 5 50 46 46 50 39 40 41 42 41 40 41 22 9 23 24 22 20 17 35 17 35 17 34 33 35 17 34 33 35 17 37 19 42 40 41 22 9 23 43 45 45 45 46 30 48 46 6
4 5 22 141 98 99 100 97 106 107 108 37 52 67 118 119 51 29 104 101 134 135 36 12 13 14 15 71 109 119 36 35 119 121 99 123 136 113 130 107 132 18 140 95 42 109 110 85 86 90 95 124 125 126 127 88 95 124 125 126 127 88 95 124 138 32 141 143 144
4 5 113 7 8 9 10 11 12 13 14 15 81 17 18 19 20 50 22 23 68 69 92 27 28 17 45 32 33 34 35 36 37 38 39 40 41 42 43 17 46 47 48 49 50 51 52 79 54 55 56 57 58 59 79 61 62 63 64 65 66 67 68 25 70 71 72 73 76 78 81 82 83 84 85 86 87 88 89 90
4 5 31 7 9 10 11 24 12 16 13 14 24 15 16 12 12 24 15 16 15 16 15 16 24 21 10 14 15 16 8 13 14 18 8 8 28 25 29 28 6
4 5 123 12 35 40 77 25 32 101 44 18 23 96 97 30 32 113 28 28 8 11 39 51 52 42 91 67 66 109 67 36 43 42 103 43 91 64 44 68 60 113 109 67 66 60 95 96 79 80 105 113 73 30 32 44 31 66 36 43 68 18 107 90 108 64 99 109 66 67 36 68 107 105 113 108 45 31 66 65
4 5 125 123 8 42 47 48 45 75 71 52 49 54 55 56 85 19 46 95 15 106 105 107 112 113 114 115 116 117 118 119 120 121 122 7 124 6 126 7 46 95 44 45 50 51 52 53 54 55 56 85 19 46 43 61 62 63 64 65 66 67 68 69 70 71 72 73 74 75 76 77 78 79 80 81 16 83 84 57
4 5 190 186 8 9 10 19 14 11 16 13 18 15 20 21 7 23 24 25 26 27 28 80 30 89 32 33 34 35 36 37 38 33 103 141 112 10 19 14 142 145 36 170 39 52 130 131 132 80 134 51 136 37 138 139 103 141 57 58 59 60 146 67 148 149 46 151 70 153 72 155 156 157 76 77 160 161 162 78
4 5 6 44 8 45 9 10 18 11 31 33 32 33 31 29 26 26 24 37 38 15 35 16 17 18 19 37 38 21 27 8 23 35 24 40 40 40 39 43 40 45
4 5 203 75 8 9 10 11 12 13 159 16 17 18 19 20 21 22 24 25 26 24 28 29 30 116 112 111 34 35 36 37 43 179 180 181 41 183 43 185 45 46 47 48 49 50 188 52 190 54 55 56 57 70 59 135 61 62 63 64 168 66 197 68 69 76 85 72 73 74 67 70 77 73 79 117 81 82 69 76
4 5 14 42 12 8 16 34 40 12 8 16 34 40 12 15 16 16 38 10 40 18 44 8 12 16 16 38 10 40 18 42 32 52 41 41 17 15 16 43 44 20 21 31 22 24 54 18 33 34 11 36 37 38 34 40 41 19 43 44 45 46 47 48 49 50 51 52 53 54 55 58 58 42 59 55 6
4 5 78 8 31 32 37 34 49 35 12 37 38 20 34 50 49 51 46 46 44 44 18 58 59 60 14 35 36 13 38 20 34 50 51 62 59 60 61 58 14 74 74 74 8 76 74 6
4 5 105 101 64 65 26 67 71 72 85 65 9 10 45 17 18 15 49 16 68 31 69 93 13 48 49 68 16 56 69 73 80 68 48 31 73 57 30 35 73 69 73 57 80 56 45 17 18 48 16 68 49 31 69 73 80 56 58 50 23 69 73 80 68 25 26 27 80 47 46 40 69 35 73 56 25 26 27 43
4 5 6 86 11 50 17 74 19 71 69 75 76 40 33 10 35 74 76 71 69 41 61 43 44 22 81 55 49 84 24 55 22 81 55 83 84 24 82 22 81 55 22 81 82 47 57 73 60 59 79 53 74 33 21 22 81 82 47 24 82 22 81 55 83 84 24 82 86 86 86 7 89 86 91
4 5 82 26 8 9 26 14 15 17 16 12 19 20 22 17 22 9 28 54 48 49 50 51 52 53 54 55 56 57 58 59 60 61 62 63 64 65 66 66 67 68 69 70 71 72 73 74 75 76 77 78 79 80 81 10 83 26 83 11 10 9 26 14 15 11 35 14 16 67 36 29 66 67 68 69 70 66 80 81
