4 5 145 141 51 65 66 57 58 84 21 64 65 53 41 117 55 35 36 37 136 121 54 55 35 113 124 102 58 56 98 65 100 121 54 55 35 76 121 54 55 22 36 37 77 8 127 107 107 45 44 45 109 103 78 46 99 100 79 16 120 14 138 8 26 119 120 138 8 133 26 45 138 8 133 134 45 138 133 26
4 5 143 137 11 84 64 12 123 125 65 52 86 87 68 46 15 31 27 28 93 101 68 46 15 31 60 18 117 62 125 12 99 122 78 98 64 65 117 117 72 71 74 41 97 81 83 9 9 9 8 141 137 6
4 5 34 28 28 20 15 20 12 13 20 12 16 20 10 21 20 19 29 34 30 30 12 13 20 12 16 20 10 21 20 19 29 34 30 30 12 13 20 12 16 20 10 21 20 19 29 34 30 30 12 13 20 12 16 20 10 21 20 19 29 34 30 30 12 13 20 12 16 20 10 21 20 19 29 34 30 30 10 13
4 5 6 7 27 97 99 100 101 102 103 104 105 106 107 100 109 110 111 112 113 114 115 19 117 118 119 120 121 27 18 104 105 106 107 100 109 110 111 112 113 114 115 116 117 118 119 120 121 27 18 104 105 106 107 100 109 110 111 112 113 114 115 19 117 118 119 120 121 27 18 104 105 106 107 108 109 110 111 112
4 5 58 57 8 9 8 9 8 29 12 14 15 16 17 18 11 20 21 22 23 24 25 26 27 28 19 12 31 32 51 50 51 38 31 40 41 44 46 47 46 47 42 41 44 15 16 17 18 29 20 21 27 23 25 51 38 40 43 42 41 44 46 47 27 17 9 6 16 17 18 29 37 21 22 23 24 25 26 27
4 5 6 7 67 78 10 80 81 13 28 91 22 18 68 23 24 33 25 29 22 16 97 34 56 42 27 41 41 42 18 16 34 32 24 33 25 34 20 50 88 15 30 57 37 18 42 27 41 42 104 50 49 111 100 97 24 33 25 82 34 83 84 100 32 102 8 103 104 50 108 107 110 109 110 111 100 101 102 103
4 5 6 28 19 10 12 18 16 15 18 18 10 28 12 15 16 21 18 20 21 16 14 15 21 23 24 25 25 25 8 29 28 6
4 5 241 7 232 233 31 211 100 190 157 63 83 115 228 85 227 111 88 220 12 13 14 15 234 236 83 163 157 63 207 13 226 227 215 72 77 74 73 219 178 7 233 16 121 211 123 136 137 52 152 176 106 153 30 213 108 157 207 63 116 117 51 217 147 146 145 36 137 136 82 30 36 92 138 139 84 82 206 173
4 5 39 80 8 9 37 22 23 34 25 35 24 35 19 22 23 34 25 26 27 28 29 30 30 30 35 34 35 36 37 84 6 40 41 42 43 44 45 46 47 48 47 50 51 52 53 54 55 56 57 58 12 43 61 62 63 64 17 18 67 68 69 70 71 72 73 74 75 76 77 80 80 80 7 82 80 6
4 5 52 9 8 8 47 10 13 15 16 14 15 16 17 18 21 40 27 24 7 40 27 28 29 30 39 40 41 43 44 34 11 12 10 17 18 21 40 27 24 10 13 15 44 34 16 17 14 15 16 17 18 21 25 28 29 30 9 6
4 5 6 67 8 19 10 21 22 23 65 8 9 10 55 16 44 21 27 28 25 61 27 28 61 42 44 19 35 43 21 16 23 30 14 52 30 14 63 55 9 35 55 58 59 30 14 46 46 33 34 10 21 16 23 30 14 52 30 49 17 39 43 21 44 23 30 14 52 30 63 14 52 30 49 19 35 43 21 23
4 5 6 7 111 38 9 10 11 12 13 14 15 16 66 18 19 20 22 23 24 25 26 27 28 30 29 62 48 62 64 65 66 46 68 69 23 16 36 36 100 101 60 59 60 61 62 63 64 65 66 67 68 69 23 16 36 36 56 82 60 59 74 97 77 78 79 80 81 82 46 84 85 86 87 88 89 90 91 93
4 5 53 8 30 31 11 12 15 33 13 30 17 18 19 20 21 22 23 24 25 26 15 28 22 37 38 20 21 22 17 18 8 8 49 29 51 49 6
4 5 114 107 8 84 10 11 12 13 14 15 81 44 18 19 96 49 22 23 67 25 26 27 28 43 29 44 31 32 33 34 35 36 37 38 39 40 41 42 43 44 45 46 47 48 21 107 51 79 53 54 55 56 57 58 52 60 61 62 63 64 65 66 67 68 69 70 71 72 59 74 75 76 77 78 52 80 16 82
4 5 6 7 29 136 190 32 34 35 36 37 38 39 40 42 43 44 45 136 31 47 60 61 62 63 64 141 66 67 68 69 70 71 72 73 74 75 76 77 78 79 80 81 82 83 84 85 86 87 88 89 90 91 92 93 94 95 96 102 98 106 42 101 97 103 104 105 99 108 107 109 110 111 112 113 114 115 116 117
4 5 113 107 8 9 10 11 12 13 14 15 81 17 18 19 96 50 91 23 24 25 26 27 28 17 30 32 33 34 35 36 37 38 39 40 41 42 43 31 46 47 48 49 50 107 52 79 54 55 56 57 58 59 60 61 62 63 64 65 66 67 24 25 70 71 72 73 74 75 76 77 78 60 80 81 82 83 84 85
4 5 16 15 15 9 10 16 8 9 15 16 15 16 15 9 7 16 7 9 8 16 15 16 15 9 7 16 7 9 8 16 15 16
4 5 6 197 197 22 64 11 8 13 16 30 126 19 20 62 99 23 24 68 26 27 9 29 30 31 32 33 34 35 36 37 38 39 40 41 42 43 44 77 78 79 80 81 82 83 84 85 86 87 93 94 95 91 92 88 89 90 96 97 98 63 100 101 102 103 104 105 106 8 108 109 110 111 112 113 114 115 116 117
4 5 47 8 22 42 43 48 38 31 57 58 60 46 44 29 66 63 48 37 33 49 42 57 58 60 31 43 42 38 30 26 28 51 36 60 46 44 29 66 63 51 49 42 43 30 57 36 60 31 43 42 38 44 29 29 22 22 42 43 39 40 41 38
4 5 6 342 10 362 363 77 78 53 42 39 339 179 180 52 53 357 359 358 258 353 320 123 125 124 126 127 128 129 130 131 132 133 134 135 136 137 53 139 206 150 151 31 145 146 147 148 149 150 143 152 153 154 155 156 157 158 159 160 161 162 163 164 165 166 167 168 104 170 171 172 173 174 175 176 177 178 179 180
4 5 6 92 94 6 77 59 67 92 59 66 13 67 11 66 15 17 42 43 44 45 46 47 48 49 50 51 75 23 14 17 55 56 57 57 45 40 43 45 46 47 48 49 50 51 93 12 17 29 31 63 64 10 76 11 11 91 7 95 91 6
4 5 207 204 11 9 53 54 73 67 21 33 37 38 72 55 171 68 123 124 102 129 130 163 132 146 147 98 37 97 99 99 21 106 39 146 147 113 151 108 111 82 152 117 115 116 117 120 68 115 70 89 125 124 162 128 129 129 112 138 178 57 56 59 58 152 48 46 24 23 50 11 11 51 7 205 11 6
4 5 64 12 8 13 160 153 114 111 160 111 114 89 31 50 125 72 73 147 144 145 49 154 111 114 89 38 31 111 160 159 13 14 15 26 17 18 20 19 21 115 44 24 26 27 31 32 35 36 108 21 121 127 50 72 73 147 147 145 49 111 114 110 38 35 100 171 171 171 12 54
4 5 6 48 21 9 18 42 9 55 82 83 16 84 20 58 61 36 63 28 22 29 49 61 36 63 19 18 71 48 52 63 56 60 56 60 52 29 71 58 61 32 52 29 71 45 60 56 30 25 52 63 66 86 86 86 22 90 86 6
4 5 6 7 21 22 23 24 9 10 16 8 8 17 17 18 7 12 15 16 7 8 10 16 18 17 20 29 9 12 23 24 27 27 27 7 29 13 31
4 5 6 173 10 107 12 103 58 121 150 48 142 90 156 157 154 159 91 31 67 100 37 98 168 150 63 136 142 35 19 114 22 66 14 91 55 54 74 94 159 71 80 78 164 144 44 82 45 142 40 122 166 88 158 37 25 27 28 156 48 155 112 143 71 92 94 93 58 127 126 80 84 79 85 164 45 32 95 160
4 5 126 53 45 8 98 22 27 76 71 72 87 16 112 64 65 66 97 78 20 21 81 82 83 84 85 86 87 88 89 90 91 92 93 94 95 96 97 78 20 21 81 82 83 84 85 86 87 88 89 90 91 92 93 94 95 96 97 78 24 21 86 86 87 112 39 40 41 42 43 44 45 47 48 49 50 51 56 54
4 5 158 7 32 33 34 35 46 65 33 67 35 141 111 137 143 18 44 45 77 99 28 144 64 10 107 53 41 108 136 79 78 10 39 53 82 86 46 34 35 49 133 44 42 19 45 20 144 28 88 89 144 107 136 10 136 142 80 53 86 82 123 80 100 86 82 94 80 34 35 83 36 8 137 111 141 42 19 44
4 5 74 35 36 46 38 39 53 57 22 40 26 52 29 13 46 38 39 62 25 22 26 14 49 43 12 49 43 12 49 29 52 69 69 69 7 72 35 6
4 5 6 130 48 252 16 17 128 21 20 21 22 23 16 17 204 247 248 252 250 252 29 181 200 19 238 71 72 73 74 75 76 77 78 79 81 81 82 83 84 85 86 87 88 89 29 181 31 120 121 122 128 125 127 13 252 12 250 29 181 31 37 256 257 258 259 260 261 262 263 8 8 8 7 268 8 6
4 5 6 9 7 131 44 16 17 71 25 74 78 76 77 108 33 117 91 122 90 8 10 44 16 17 138 73 33 120 25 25 74 78 76 77 108 33 71 139 22 131 24 28 38 29 39 37 27 22 131 64 112 47 23 8 25 74 78 76 77 108 82 87 13 14 15 20 21 22 25 24 144 116 51 50 112 44 16 17
4 5 26 63 17 18 9 17 20 90 19 22 23 24 25 108 27 28 29 30 71 63 64 40 54 55 13 38 39 34 41 42 43 44 45 46 32 66 49 72 73 89 42 94 32 59 18 17 20 19 90 22 23 24 25 108 27 28 29 30 63 64 66 34 54 55 13 38 14 34 41 42 43 44 45 46 47 66 18 72
4 5 6 34 129 20 58 128 20 124 173 66 50 79 69 31 70 55 65 93 94 177 89 11 12 49 53 56 54 69 51 56 151 152 151 28 29 144 138 139 140 141 33 34 137 49 53 54 56 51 52 52 51 151 152 151 28 29 144 50 31 29 30 33 34 177 89 11 12 49 53 54 56 51 52 51 153 151 152 171
4 5 116 7 36 26 31 23 30 71 35 42 109 81 103 17 105 60 30 71 38 34 107 108 109 108 109 49 31 31 30 71 29 28 29 30 31 61 74 17 18 10 73 74 17 76 90 91 70 77 79 58 71 77 79 53 87 96 74 11 44 13 16 19 64 105 32 71 72 77 52 87 110 110 110 8 114 61 116
4 5 6 91 12 22 35 33 35 52 8 25 31 32 84 43 20 45 66 62 25 26 27 42 43 73 32 41 36 33 35 38 37 52 14 59 87 59 42 73 74 52 14 59 52 66 62 55 67 57 31 74 65 64 67 16 86 86 86 19 92 83 6
4 5 88 7 46 20 21 33 45 34 35 64 31 9 33 23 27 59 60 24 23 59 66 7 81 87 7 83 7 86 83 6 25 27 29 60 30 46 31 9 33 18 19 64 45 34 35 34 35 74 9 22 67 76 19 52 68 54 53 67 54 68 67 53 65 59 66 74 9 22 23 29 25 26 27 77 69 56 34 35
4 5 78 8 61 61 58 59 60 13 68 67 65 57 14 15 64 65 18 21 37 13 48 45 57 65 64 48 70 69 37 9 37 20 21 68 67 37 65 64 48 14 15 45 21 57 65 64 48 13 69 70 37 65 18 19 20 8 13 68 21 48 65 64 14 15 65 64 29 13 54 15 57 65 64 48 13 45 56 69
4 5 6 114 9 10 13 43 58 15 16 17 21 66 68 89 46 79 74 97 73 31 32 62 63 45 85 91 71 48 49 50 46 52 53 54 39 58 59 60 61 62 63 9 10 17 16 15 115 60 36 6 66 9 10 59 58 15 16 17 21 31 32 62 9 66 58 59 40 41 42 43 44 36 46 47 48 49 50 46
4 5 257 250 9 207 172 209 210 211 212 213 214 215 216 217 218 219 73 221 16 190 47 40 39 94 16 17 47 42 37 38 39 157 183 184 54 58 57 185 60 61 62 63 62 77 72 172 131 71 134 135 136 137 138 139 140 141 142 143 144 145 146 147 148 149 84 94 95 96 98 154 156 157 158 159 98 105 158 124
4 5 6 56 11 57 9 9 23 53 37 17 27 16 43 37 12 20 14 44 24 32 14 16 43 15 44 16 17 9 9 39 32 26 8 20 21 15 18 44 45 43 16 15 29 9 16 43 37 38 16 44 32 26 8 8 8 11 55 53 57
4 5 6 8 51 52 79 80 41 82 67 46 47 48 49 50 51 52 135 39 80 41 77 114 54 116 117 118 119 122 120 128 68 84 85 86 87 88 89 90 91 92 93 94 95 96 97 98 99 100 101 102 103 132 133 134 138 138 138 7 140 8 142
4 5 55 9 8 39 38 15 8 39 38 37 41 35 47 48 28 18 39 23 24 17 35 55 50 18 19 11 17 13 48 6 48 28 43 43 35 55 50 50 23 11 25 33 14 23 24 45 18 19 41 35 47 48 21 50 23 16 25 14 30 25 33 14 15 24 45 18 19 43 47 13 48 43
4 5 64 61 8 8 9 10 11 12 13 14 15 17 18 19 20 21 22 23 24 25 26 27 28 29 30 31 32 30 15 56 55 56 18 25 26 27 13 14 15 56 29 30 31 32 42 43 44 45 46 47 48 49 50 26 52 53 54 55 56 57 58 7 58 7 62 58 11
4 5 90 85 15 16 10 11 12 13 14 15 16 49 51 13 14 15 16 49 71 13 36 53 48 44 14 15 16 77 24 71 13 36 48 42 57 57 34 34 41 17 18 19 20 81 69 68 82 26 80 54 26 28 32 33 37 34 39 40 41 17 36 45 44 49 45 59 58 64 26 69 73 26 80 56 26 28 32 33
4 5 6 216 189 56 13 8 15 16 11 12 18 19 20 21 22 23 24 25 26 27 28 29 30 31 32 33 34 35 36 37 38 39 40 41 42 43 44 45 46 47 48 49 50 51 52 53 54 55 56 57 9 59 60 61 62 63 64 65 66 67 68 69 70 71 72 73 74 75 76 77 78 79 80 81 82 83 84 85
4 5 231 228 226 231 28 24 231 27 30 31 8 33 118 83 104 212 21 104 35 71 40 11 28 88 164 223 47 190 105 191 47 223 24 44 31 36 90 97 42 98 93 95 30 31 53 35 36 198 148 107 200 197 107 149 117 186 43 69 210 109 153 54 114 110 219 44 138 153 60 35 63 71 57 56 84 23 87 23
4 5 6 74 61 33 63 31 65 61 54 41 72 69 9 17 27 19 36 37 27 28 57 31 33 47 60 59 13 34 47 60 59 47 60 48 13 34 47 33 57 31 34 47 13 34 47 33 57 31 34 47 13 34 47 33 57 31 34 47 13 34 47 33 57 31 34 47 13 34 47 33 57 31 34 47 13 34 47 33
4 5 316 312 269 15 72 78 254 255 256 257 258 259 260 261 262 263 264 265 266 267 229 269 50 33 272 273 53 277 307 277 278 279 280 152 53 283 284 285 286 287 288 289 290 291 290 293 294 283 296 297 298 299 69 153 302 303 152 221 275 307 308 309 8 311 311 7 314 311 6
4 5 333 228 11 12 13 14 43 16 105 18 19 217 312 22 23 24 106 26 27 28 29 30 31 162 33 34 35 36 37 38 39 47 48 89 15 44 45 46 89 48 301 50 43 54 88 109 159 202 144 145 146 147 148 149 150 151 152 153 154 155 156 157 158 159 160 161 162 163 33 165 166 167 168 169 170 171 172 173
4 5 294 293 234 9 10 231 12 13 14 15 16 17 18 19 20 21 29 23 24 25 26 27 28 22 30 23 32 33 34 36 35 37 38 39 189 252 42 43 44 45 46 47 48 49 50 51 52 53 54 55 56 57 58 59 197 198 199 200 201 202 203 204 205 206 207 208 209 211 212 213 214 215 30 217 218 219 220 221
4 5 6 72 8 9 10 11 12 54 14 39 65 41 22 20 19 38 34 35 41 17 44 45 65 47 48 49 50 51 55 53 13 55 56 57 35 59 60 61 62 63 64 35 66 67 68 69 10 22 70 71 32 72 72 33 76 72 78
4 5 137 133 8 72 10 11 12 13 14 15 20 71 18 130 130 7 20 21 47 48 39 94 94 53 52 54 55 56 85 15 8 18 20 27 29 30 31 32 33 34 35 36 37 38 39 40 41 42 43 44 22 46 47 48 49 50 51 52 53 54 55 56 57 58 59 60 61 62 63 64 65 66 67 68 69 20 17 72
4 5 57 56 9 10 19 43 44 11 8 14 16 15 18 12 17 29 6 21 22 23 30 36 26 27 28 29 30 44 32 33 34 30 25 20 38 47 28 29 30 44 37 8 18 40 39 40 39 20 21 22 23 30 36 26 27 28 29 30 44 32 33 51 51 51 7 55 51 57
4 5 6 8 7 6 10 9 6 9 6 9 6 9 6 9 6 9 6 9 6 9 6 9 6 9 6 9 6 9 6 9 6 10 6
4 5 6 33 8 9 10 11 12 13 14 104 16 17 32 19 20 21 202 23 192 25 26 27 28 29 30 251 20 21 196 46 193 82 124 139 140 141 125 126 128 129 155 251 221 222 223 224 225 226 227 228 229 230 231 232 232 88 51 186 33 33 178 112 45 59 167 168 169 103 104 25 26 27 28 29 30 162 20 21
4 5 6 100 10 11 66 21 84 46 63 86 88 89 90 91 92 75 97 21 22 15 24 25 58 28 35 26 27 38 49 50 51 52 53 34 40 41 42 43 44 45 46 47 48 49 50 51 52 53 54 55 56 35 37 60 73 62 63 64 65 66 67 68 69 70 71 72 73 92 75 6 77 78 79 80 9 82 83 84
4 5 59 53 8 9 8 9 20 8 9 8 27 20 8 9 14 15 16 17 18 19 20 21 22 23 24 25 26 27 9 28 29 30 31 51 37 50 51 37 30 40 41 44 45 46 47 46 38 24 16 38 24 55 28 12 30 37 40 41 42 43 44 45 47 46 47 42 43 44 45 26 17 28 33 20 46 49 51 50
4 5 232 228 51 186 103 54 55 14 91 9 67 96 76 75 128 129 224 84 142 65 66 22 68 72 19 92 93 56 97 73 80 119 128 129 224 132 61 62 221 185 200 187 159 138 139 140 117 94 182 183 184 185 102 187 188 189 164 191 192 196 183 195 197 158 178 154 74 75 76 128 129 28 44 45 202 203 204 205
4 5 273 270 10 11 16 13 53 214 218 15 11 16 13 52 187 195 196 233 197 81 216 218 213 84 262 254 131 234 235 176 155 59 124 97 100 139 64 25 23 153 156 40 183 260 24 201 65 12 67 156 140 141 142 143 97 19 158 237 127 240 229 145 46 146 147 150 61 79 144 145 25 24 246 247 56 85 256 183
4 5 284 8 7 210 22 23 254 34 120 121 266 224 66 270 67 138 142 204 205 252 31 30 105 32 110 10 260 135 186 193 173 184 46 39 40 54 256 257 10 222 135 248 15 123 138 126 142 144 121 109 34 112 186 255 131 132 7 10 222 123 14 15 262 266 230 68 270 218 175 186 179 168 113 53 263 118 117 243
4 5 6 27 28 34 35 36 18 20 26 17 29 42 24 16 12 11 10 18 52 36 18 19 54 57 22 24 45 28 29 35 53 44 8 33 29 35 20 17 11 12 16 37 51 56 51 38 39 53 44 8 33 29 35 54 16 12 11 23 41 42 39 57 22 24 45 19 55 53 44 8 28 29 42 12 11 16 37 16
4 5 229 224 51 197 102 54 55 56 90 21 166 22 61 62 100 183 53 137 138 139 141 93 199 179 180 134 193 182 52 184 185 131 188 221 193 189 76 84 141 154 188 126 127 128 64 131 130 131 81 134 193 136 137 138 139 141 94 45 199 70 46 86 179 180 95 178 79 79 76 17 174 157 80 131 82 76 136 35
4 5 40 7 8 9 10 11 30 12 8 9 10 24 14 17 18 16 24 19 19 27 17 11 30 25 12 9 10 24 21 21 5 40 7 8 9 10 24 21 19 16 11 12 30 25 8 9 9 24 19 17 27 24 15 12 23 21 21 19 25 9 11 12 30 14 7 9 10 24 21 19 17 27 24 15 12 25 34 34
4 5 176 72 65 81 85 83 151 152 153 154 155 156 158 159 160 161 162 14 164 165 100 167 168 169 7 73 14 75 76 73 14 75 79 80 81 82 83 84 85 86 87 88 89 90 91 92 93 94 95 96 74 15 99 100 101 102 103 18 105 106 107 108 37 110 111 112 113 114 115 116 118 119 120 121 122 123 124 125
4 5 6 9 24 25 26 27 37 28 46 43 34 78 58 45 33 16 64 59 81 82 87 94 52 39 87 37 37 70 38 19 62 59 45 85 28 91 93 92 90 95 44 96 98 54 30 31 47 19 52 39 87 37 70 37 78 69 83 84 57 81 82 38 94 27 41 84 45 85 91 93 92 90 95 97 54 29 44 95
4 5 6 22 8 10 32 12 13 14 15 16 17 18 19 20 21 70 23 24 12 26 27 28 29 30 31 32 12 34 35 36 37 38 39 40 41 42 43 44 45 46 47 48 49 50 51 52 53 54 55 56 40 18 61 54 55 23 24 59 44 45 47 48 62 39 40 41 42 43 44 45 46 47 48 49 50 51 52 53
4 5 66 108 69 14 12 75 83 70 79 78 77 71 72 74 11 13 83 75 104 103 91 53 54 55 56 57 58 66 46 61 62 63 64 65 36 67 66 69 70 71 72 73 74 75 76 77 78 79 80 81 40 83 84 85 86 87 88 30 90 91 23 93 94 95 37 97 98 99 100 101 102 103 104 105 106 107 7 109
4 5 130 127 7 9 32 12 16 15 21 20 14 29 62 63 72 69 11 12 16 17 35 36 13 14 15 16 17 21 50 20 24 29 63 74 118 33 95 95 96 97 93 96 97 91 9 81 33 15 16 21 20 23 57 24 50 63 72 120 10 33 106 102 54 93 96 97 91 120 74 75 76 120 76 76 127 127 127 127
4 5 71 8 23 24 11 15 44 40 62 63 29 17 14 28 18 40 44 50 9 10 63 17 14 15 46 58 64 43 52 64 44 40 18 40 29 20 21 46 59 18 31 21 41 17 49 65 66 66 35 69 65 6
4 5 141 135 8 20 19 125 28 10 36 102 23 23 128 63 7 13 128 37 66 39 83 47 41 60 131 73 73 56 85 37 38 39 101 27 28 59 61 54 41 124 47 23 62 83 73 73 64 37 66 67 124 41 27 126 68 98 98 110 88 96 66 39 44 69 45 87 128 108 76 102 48 116 110 108 77 76 56 85
4 5 129 7 8 86 10 11 12 13 14 15 16 45 18 19 20 51 22 23 24 25 26 27 28 45 30 32 33 34 35 36 37 38 39 40 41 42 43 45 46 46 50 7 53 80 55 56 57 58 59 60 61 62 63 64 65 66 67 68 69 70 71 72 73 74 75 76 77 78 79 80 81 16 84 85 9 87 88 89
4 5 6 8 31 47 33 77 25 42 134 71 72 69 67 128 78 42 16 18 11 90 83 101 99 97 105 108 17 108 134 115 116 139 114 76 12 82 140 119 120 72 69 68 84 85 100 102 101 98 97 139 108 15 109 108 134 116 115 139 118 142 82 140 119 120 75 79 80 42 128 121 94 91 93 88 84 83 101 98
4 119 104 251 76 177 187 188 189 190 192 193 192 149 155 156 208 213 163 211 167 170 145 144 148 149 150 151 152 204 154 155 156 169 211 167 170 144 145 148 149 36 121 252
4 5 70 31 61 16 8 9 10 12 13 14 15 16 17 18 19 20 21 22 23 24 24 26 62 63 63 57 58 19 17 18 55 20 9 23 29 30 63 33 34 44 46 50 52 22 49 21 51 52 42 33 34 44 46 50 53 48 49 50 51 52 53 54 55 56 34 58 60 61 62 63 65 65 65 31 68 32 6
4 5 6 49 25 26 13 38 29 30 29 11 10 13 46 40 19 17 15 16 40 39 17 19 42 42 10 31 47 21 22 23 12 15 16 40 21 22 23 12 15 16 18 21 47 34 43 15 16 18 19 17 24 25 26 45 28 29 30 29 11 44 13 46 18 39 17 19 51 51 51 49 53 50 55
4 5 57 51 12 17 18 30 13 34 7 49 11 10 52 16 33 18 30 13 34 32 15 11 10 52 16 48 18 30 13 34 52 13 18 34 17 14 34 49 53 16 13 18 30 30 32 49 11 10 52 52 16 48 14 30 13 34 52 13 18 32 15 46 10 52 16 48 14 30 13 34 52 33 18 52 49 32 46 10
4 5 6 7 38 17 14 33 45 53 56 35 34 54 21 56 55 48 49 51 77 23 52 74 52 39 18 75 42 42 45 73 45 55 56 57 35 34 54 25 22 79 24 78 79 51 77 49 25 23 52 87 85 37 75 78 49 51 13 75 78 49 51 17 18 75 42 45 73 29 67 67 7 92 67 94
4 5 7 85 99 36 63 38 34 31 40 32 37 29 51 42 49 48 49 62 65 83 45 10 23 62 12 83 45 10 50 51 36 28 61 78 42 77 71 9 44 45 10 23 68 12 83 65 44 45 50 35 77 42 18 83 9 44 65 35 23 24 12 83 44 65 19 80 40 34 31 32 52 36 28 38 51 20 61 45
4 5 6 50 50 208 167 86 87 180 96 232 71 216 219 231 224 222 118 73 160 94 173 167 166 167 46 93 174 231 224 225 211 110 93 214 219 218 39 21 24 25 143 12 13 14 15 214 219 216 220 21 22 77 130 131 132 185 134 56 33 94 73 54 55 56 33 174 167 166 167 46 93 174 167 166 232 71 75 104
4 5 6 7 47 37 38 39 40 41 42 43 44 45 46 27 37 10 39 40 41 42 43 44 45 46 74 9 10 50 51 52 53 54 55 56 57 58 59 60 61 62 63 64 65 66 67 68 69 70 71 72 31 74 74 27 27 78 79 74 6
4 5 6 8 11 12 13 301 43 16 17 18 19 287 21 22 104 24 25 26 27 28 29 30 31 32 33 34 35 150 37 38 39 42 43 42 15 44 45 46 42 43 299 50 43 54 88 106 18 104 33 103 104 24 152 27 154 29 25 108 109 110 111 237 68 114 115 116 117 118 119 120 121 122 123 124 125 126 127 128
4 5 6 136 8 9 48 114 55 108 29 30 114 116 32 35 108 29 46 114 47 116 32 33 34 35 36 37 38 39 40 51 42 43 29 46 115 116 50 11 27 52 53 54 95 56 57 58 73 46 75 76 77 21 79 81 84 85 104 52 88 89 90 91 92 93 94 124 26 33 34 126 37 103 12 105 67 68 69 70
4 5 124 7 75 100 12 13 79 15 52 53 18 19 20 21 22 23 24 25 26 27 28 29 30 77 84 96 34 35 36 37 84 39 40 41 42 84 44 45 46 47 48 49 50 51 16 53 54 55 56 92 58 59 60 61 62 63 64 65 66 67 68 69 70 71 72 73 55 75 76 77 20 79 81 82 100 20 21 86
4 5 6 8 48 49 41 98 67 95 96 97 98 68 44 130 130 69 69 119 120 33 85 90 53 15 55 56 137 61 134 137 70 62 32 129 75 126 58 15 137 138 138 149 89 88 66 91 35 100 102 92 149 104 106 110 83 106 108 79 137 56 128 91 137 30 68 16 17 90 128 61 134 88 21 104 83 106 108 108
4 5 203 198 198 176 64 10 11 12 15 16 17 18 19 62 63 22 23 68 25 26 8 28 16 30 31 32 33 34 35 36 37 38 39 40 41 42 43 77 78 79 80 81 82 83 91 92 93 94 95 96 97 98 176 100 101 102 103 104 105 107 108 54 55 120 23 15 72 152 17 128 129 130 132 133 134 135 136 137
4 5 178 158 12 47 14 45 148 16 17 14 80 90 84 120 22 61 40 111 77 41 70 40 22 126 167 30 111 32 21 83 90 46 13 19 75 74 80 112 145 86 110 7 104 162 58 167 169 170 171 99 99 7 176 64 178
4 5 126 52 109 9 14 15 61 13 14 16 17 18 19 20 21 22 23 113 80 109 111 98 99 100 37 19 20 16 43 44 32 50 64 106 107 108 109 110 109 23 24 103 111 98 99 100 37 19 20 16 83 21 114 80 115 80 10 28 16 17 18 19 20 21 22 95 113 80 109 111 98 99 100 37 19 20 16 83
4 5 61 58 8 8 49 26 34 47 11 47 16 26 51 52 24 22 21 24 15 21 22 24 15 51 13 51 52 51 37 34 57 29 30 44 32 38 39 37 11 46 41 16 35 31 32 38 35 16 52 19 40 15 35 31 32 36 13 51 52 19 53 16 51 52 19 40 15 53 31 32 31 15 35 16 7 29 43 44
4 5 222 216 28 197 160 31 21 13 197 94 37 19 35 129 121 96 88 159 41 45 159 13 197 199 200 85 197 87 88 183 152 10 95 197 199 157 125 126 91 173 209 210 36 82 71 95 204 168 131 209 210 57 40 56 16 82 71 9 161 70 71 197 85 148 51 157 125 126 91 173 209 210 213 214 215 7 62 160
4 10 11 203 148 75 26 20 21 22 23 184 25 34 27 29 30 31 32 54 55 50 57 58 59 112 61 168 63 64 65 66 67 68 69 70 71 59 42 74 35 76 89 90 79 152 81 31 30 32 92 80 89 78 198 199 28 63 28 197 109 29 157 77 123 140 156 157 164 160 161 163 164 165 161 167 168 169 170 203
4 5 159 7 8 9 38 11 12 13 14 35 38 17 18 19 20 21 22 23 24 25 26 27 28 29 30 31 32 33 34 15 36 37 16 49 40 41 42 52 44 45 46 47 48 39 50 51 52 53 54 55 56 57 58 59 60 61 62 63 64 65 145 67 68 29 70 71 72 73 74 38 76 77 78 79 80 81 82 83
4 5 116 115 63 64 94 66 67 77 78 70 64 65 66 67 68 97 84 98 99 39 20 13 21 79 89 21 105 30 93 71 95 52 102 90 35 36 81 38 39 40 41 42 42 61 43 44 45 46 47 33 60 59 89 21 79 105 30 110 113 110 7 114 110 6
4 5 6 7 8 10 66 33 67 87 88 19 49 19 30 6 7 22 53 41 48 39 121 39 22 53 32 48 110 29 30 27 67 33 118 119 120 121 91 110 60 95 17 18 66 62 33 67 87 34 27 19 13 16 17 18 117 116 15 14 119 114 11 13 17 18 19 30 110 29 103 92 45 73 22 53 41 53 47 48
4 5 23 119 60 81 81 82 83 84 85 86 17 69 25 73 51 81 15 67 33 110 112 88 115 71 25 44 27 103 18 105 63 19 42 78 29 34 13 103 75 43 38 32 29 78 32 29 32 38 86 81 87 69 61 81 35 105 63 14 108 108 63 75 36 28 26 51 103 67 66 39 83 75 26 58 81 82 83 84
4 5 6 188 19 9 48 49 12 13 66 67 16 68 18 19 40 42 22 23 53 95 46 97 28 113 30 31 32 33 34 35 36 39 38 39 160 41 42 42 73 45 46 97 48 49 12 51 52 24 54 55 56 57 58 59 60 61 62 63 64 65 66 67 68 69 70 71 72 73 74 30 86 87 34 89 90 91 92 93
4 5 6 27 10 10 112 9 31 44 101 46 58 8 105 60 61 62 43 64 68 101 36 58 72 8 9 31 44 94 35 36 42 60 64 62 43 94 70 41 50 98 64 62 43 73 64 67 91 73 43 67 39 100 72 99 100 94 95 67 99 104 54 112 112 112 7 116 11 118
4 5 6 67 14 14 7 51 59 60 14 36 58 53 10 54 18 17 19 18 61 39 51 53 10 54 11 24 18 32 40 63 41 33 42 19 39 63 40 53 10 51 59 60 14 28 58 23 10 18 19 18 42 19 61 10 53 24 10 51 50 60 26 27 28 29 65 39 32 33 40 63 17 19 64 34 27 36 29 51
4 5 63 57 12 48 8 9 33 39 10 13 14 15 16 17 18 19 20 21 22 23 26 24 18 24 27 37 44 39 40 22 41 42 37 44 39 48 12 48 50 50 54 52 53 31 32 44 45 35 36 55 33 39 40 22 42 41 37 33 39 12 48 22 26 23 10 13 14 15 10 43 38 34 48 47 48 55 55 55
4 5 11 7 8 8 46 39 38 20 18 19 13 24 34 35 26 27 38 33 39 38 20 18 19 34 25 26 44 33 27 20 39 38 38 34 25 36 18 19 20 42 38 39 38 10 47 47 47 7 51 47 6
4 5 15 92 50 51 52 40 54 17 18 19 20 63 22 23 24 25 26 27 28 29 31 30 33 34 24 34 44 36 37 38 57 53 54 78 44 49 50 51 39 40 59 60 61 62 21 61 22 66 67 68 69 70 71 72 73 74 75 76 77 78 79 80 81 39 83 84 85 86 87 88 89 90 91 92 92 92 92 96
4 10 183 70 29 28 20 15 77 17 18 67 14 22 100 56 69 42 28 86 89 88 82 74 79 69 23 24 25 102 26 127 128 60 79 33 34 132 70 118 31 120 155 115 101 100 24 23 102 103 25 102 26 127 128 166 167 149 115 170 171 70 16 32 33 34 28 61 142 82 74 133 134 135 78 33 34 35 37 36
4 5 6 44 25 25 31 18 24 27 32 33 23 24 27 30 16 39 31 9 18 11 20 10 11 39 40 21 38 25 10 19 25 39 40 42 14 32 33 10 19 27 30 16 39 8 9 23 11 20 21 23 19 38 25 39 40 21 38 25 32 33 18 19 25 31 29 30 41 19 47 36 36 46 48 36 50
4 5 367 93 11 12 13 14 41 56 106 18 19 218 21 22 23 24 107 26 27 28 29 30 31 284 33 34 35 152 37 38 39 89 41 47 41 44 45 46 47 41 322 50 15 54 224 106 18 23 33 154 345 347 216 133 139 265 134 136 135 138 139 140 141 83 143 350 145 146 147 148 149 150 151 152 153 154 155 156
4 5 126 120 11 14 106 42 58 19 20 23 22 15 15 17 63 17 17 7 48 32 50 51 30 34 101 28 45 86 135 136 27 136 52 70 78 81 117 115 73 116 70 71 81 75 83 12 85 107 108 55 136 93 136 100 107 108 102 103 111 32 113 77 120 120 120 7 124 120 126
4 5 113 107 8 84 10 11 12 13 14 15 16 17 18 19 20 21 22 23 24 25 26 27 28 45 31 32 33 34 35 36 37 38 39 40 41 42 43 17 46 47 48 49 21 7 52 60 54 55 56 57 58 59 53 61 62 63 64 65 66 67 24 25 70 71 72 73 79 75 76 77 78 74 80 16 82 83 9 85
4 5 6 26 8 10 12 13 14 15 15 21 22 59 9 23 24 54 37 22 26 10 51 15 12 17 14 15 15 21 22 22 9 28 29 30 31 32 33 19 47 36 35 34 36 40 41 40 41 19 49 30 50 51 15 51 15 12 17 13 14 15 15 36 19 22 21 22 18 41 51 45 36 35 34 15 21 22 23 24
4 5 6 57 24 16 37 32 47 44 45 34 32 24 22 37 34 35 35 45 44 45 32 34 30 24 22 17 34 35 35 45 44 45 32 34 30 40 10 51
4 5 6 65 8 20 10 41 12 13 14 15 16 17 18 19 49 21 51 23 24 25 26 27 28 29 65 31 40 33 34 35 36 37 38 39 32 11 42 43 44 45 46 47 48 49 50 22 52 53 54 55 56 57 58 59 60 61 62 63 67 65 65 7 68 65 70
4 5 112 109 8 9 10 11 12 13 14 15 80 17 18 19 20 21 22 23 24 25 91 27 28 17 29 31 32 33 34 35 36 37 38 39 40 41 42 17 45 46 47 48 21 108 51 52 53 54 55 56 57 58 52 60 61 62 63 64 65 66 67 68 69 70 71 72 59 74 75 76 77 52 79 80 81 82 9 84
4 5 121 83 41 91 42 52 44 37 73 104 102 103 104 55 54 55 56 57 58 113 114 111 75 49 71 77 111 75 41 113 37 22 63 68 103 104 42 44 22 25 23 109 110 26 28 63 64 65 12 66 41 93 22 49 50 59 43 53 20 56 83 67 66 58 22 49 71 94 65 47 48 62 29 66 67 102 103 104
4 5 8 14 10 23 25 21 22 23 25 26 27 28 8 33 21 22 26 27 28 8 33 21 35 26 27 28 7 33 21 35 26 27 28 8 33 21 22 26 27 28 8 33 21 22 26 27 28 8 33 21 22 26 27 28 8 33 21 35 26 27 28 7 33 21 22 26 27 28 7 33 21 22 26 27 28 7 33 25
4 5 168 33 29 44 81 46 96 28 130 44 31 46 145 98 72 61 11 17 18 141 20 149 132 79 149 145 22 130 29 30 45 46 96 139 107 119 71 39 79 20 18 141 145 14 144 71 39 149 150 136 145 98 144 71 39 152 64 97 67 119 104 139 86 72 145 147 52 96 7 34 132 30 81 46 79 33 31 46
4 5 69 66 60 60 11 12 38 52 53 54 55 51 21 47 43 58 50 51 21 47 19 22 30 42 28 28 49 10 7 30 62 42 63 33 9 21 43 47 52 53 54 55 51 21 47 13 52 53 54 55 51 21 47 13 19 18 28 28 28 10 63 63 62 67 63 6
4 5 6 7 42 42 43 50 51 66 18 68 77 14 15 72 20 21 22 29 44 52 55 23 24 38 81 35 59 12 38 44 50 52 55 23 24 56 53 54 35 38 44 50 52 25 77 20 27 28 38 64 65 17 67 19 69 70 71 72 25 77 78 78 7 82 78 84
4 5 6 45 8 9 95 36 68 56 57 35 33 37 25 79 61 46 47 48 49 50 39 25 79 31 29 32 36 11 35 33 37 45 41 61 11 38 51 41 31 29 32 36 11 35 33 37 55 25 23 61 11 38 51 48 49 50 39 25 79 31 29 32 36 11 35 33 37 45 23 61 11 38 51 62 64 65 41 108
4 5 6 46 46 50 39 40 41 42 41 40 24 18 12 24 8 9 23 20 40 39 38 37 39 40 41 42 41 27 9 23 20 44 50 38 12 8 18 10 11 12 22 40 39 38 37 24 22 20 9 23 27 20 38 17 35 35 34 18 34 35 34 35 17 45 46 46 7 48 46 6
4 5 22 141 98 107 108 104 52 67 68 69 70 124 125 126 86 90 36 119 53 16 55 75 76 77 73 28 29 101 94 86 84 85 86 87 88 95 42 43 92 93 94 95 96 97 98 107 100 104 79 106 107 108 55 43 129 106 131 100 114 60 37 66 63 64 66 63 26 65 60 62 53 54 55 75 76 77 73 28
4 5 113 7 8 9 10 11 12 13 14 15 81 31 18 19 20 21 22 23 68 69 92 27 28 17 45 32 33 34 35 36 37 38 39 40 41 42 43 30 46 47 48 49 50 51 52 79 54 55 56 57 58 59 79 61 62 63 64 65 66 67 68 69 70 71 72 73 53 75 76 77 78 79 80 81 82 83 9 85
4 5 31 7 9 13 11 24 12 12 24 12 16 15 16 24 12 13 14 21 10 11 15 16 24 12 13 14 15 16 24 12 12 24 15 16 15 16 24 12 10 14 18 18 7 9 13 11 21 9 10 11 15 16 24 12 12 24 12 21 23 12 24 15 16 15 16 24 12 24 12 12 24 21 10 11 15 16 24 12
4 5 123 12 35 40 77 25 32 101 44 95 97 30 60 44 31 64 45 113 109 65 66 67 43 18 10 96 60 101 100 95 113 97 30 60 95 113 97 39 51 41 42 43 109 65 66 67 36 43 107 106 36 107 90 108 64 31 109 67 93 68 107 18 45 113 95 97 14 80 55 58 47 78 123 58 47 78 23 96
4 5 125 123 8 42 26 48 45 75 19 20 21 22 23 24 25 47 27 28 29 30 31 32 33 34 35 36 37 38 39 40 128 42 43 48 45 46 26 48 49 50 51 52 53 54 55 56 85 19 46 43 15 62 63 64 65 66 67 68 69 70 71 72 73 74 75 76 77 78 79 80 81 88 83 84 57 86 87 82
4 5 6 7 8 9 10 19 14 11 16 15 12 18 15 12 20 11 20 98 21 121 24 113 105 27 132 133 30 89 32 33 34 35 36 137 138 39 40 42 43 44 114 115 40 115 111 125 47 127 49 52 130 131 132 133 134 51 136 37 138 33 103 141 57 58 59 60 146 147 148 149 46 151 70 153 72 155 156 157
4 5 6 7 8 36 9 10 18 11 35 15 26 37 38 26 26 24 37 38 16 17 18 19 37 38 21 27 8 23 35 24 42 7
4 5 6 75 8 9 10 11 12 13 14 159 16 17 18 19 20 21 22 27 25 26 24 28 29 30 116 32 111 34 35 36 37 184 39 40 41 183 38 185 45 46 47 48 49 113 188 189 190 54 55 56 83 76 134 135 61 62 63 64 65 66 197 68 57 70 85 72 73 74 67 70 77 99 79 117 81 82 69 70
4 5 14 42 8 12 8 16 39 40 12 15 16 18 38 20 40 12 41 52 53 54 19 43 54 55 33 10 35 36 8 16 38 39 40 41 19 43 44 45 46 47 48 49 50 51 52 53 54 55 55 55 42 59 55 6
4 5 78 75 31 32 33 34 20 39 40 41 42 43 35 12 33 38 43 38 34 20 40 50 49 51 52 51 46 44 46 40 44 58 59 60 14 32 33 38 66 36 68 63 30 31 32 13 34 40 53 35 36 37 38 20 49 43 45 46 44 46 18 54 49 66 32 68 23 56 61 17 58 51 52 50 46 46 44 38
4 5 105 63 64 65 26 10 16 85 65 86 67 45 49 15 80 68 16 73 80 68 31 50 56 51 69 68 80 56 25 86 27 80 47 42 40 35 30 69 33 83 18 17 18 40 45 82 55 58 59 63 63 99 7 103 63 6
4 5 6 90 11 50 42 62 63 33 70 73 57 64 76 74 35 20 19 20 40 70 57 73 69 75 76 40 33 14 19 20 40 41 42 31 44 22 24 82 83 46 41 42 31 44 19 24 83 46 82 73 69 57 73 22 30 55 47 17 74 20 19 20 70 57 73 59 72 76 14 40 59 72 76 35 74 20 19 20
4 5 29 10 8 9 7 14 15 17 15 16 17 15 19 14 15 24 20 24 9 10 54 49 50 51 52 53 54 55 47 48 49 50 51 52 53 54 55 56 57 58 59 60 61 62 63 64 65 66 67 68 69 70 71 72 73 74 75 76 77 78 79 80 81 82 83
