26 11 21 27 34 6 33 25 12 24 24 13 6 4 32 8 7 19 17 10 24 16 4 32 5 35 28 29 14 23 23 16 4 32 5 35 8 29 14 23
14 14 4 13 17 8 13 10 12 15 12 16 18 14 12 17 8 18 14 10 12 7 12 13 14 13 14 12 12 13 14 13 14 12
6 6 14 13 14 5 14 5 13 14 5 14 13 14 5 14 14 13 13 5 14 5 14 14 13 13 5 14 14 14 13 5 14 5
6 8 27 24 11 33 33 22 18 6 25 18 32 4 21 21 7 19 26 10 19 33 22 30 18 6 25 26 32 4 21 21 4 24 11 33 22
13 21 21 7 7 18 16 23 13 8 21 14 21 14 18 5 23 13 5 21 14 7 21 22 16 13 13 21 21 14 18 16 23 13
16 4 11 7 15 15 15 15 7 7 13 7 15 15 15 5 13 7 15 15 15 15 7 13 7 15 15 15 14 7 13 7 15 15
38 18 11 6 4 10 7 27 36 40 17 37 14 32 34 30 15 16 22 8 16 35 26 22 13 31 20 30 22 8 16 35 26 22 13 31 20
10 6 16 4 14 15 9 9 9 9 4 8 6 10 6 16 6 14 15 9 9 4 8 6 10 6 16 6 14 15 9 9 4 14
7 7 9 4 10 5 13 6 12 14 15 9 4 10 5 13 6 12 15 14 11 9 4 10 5 13 6 12 11 14 7 9 4 10 5 13 6 12 15 14
12 12 13 10 15 14 11 17 17 17 17 17 11 12 7 11 7 7 7 14 13 10 6 17 17 17 17 15 12 7 10 10 11 6
13 13 21 34 22 7 4 14 16 15 12 24 5 20 30 33 27 9 10 17 11 8 18 29 27 31 28 26 25 34 26 23 15 12 24 5 20 30 33 27 28 26 9 10 18 11 8 18 29 27 31 28 19 25 34
5 15 10 21 15 10 7 15 12 5 8 13 18 12 5 8 15 10 15 7 18 12 19 8 13 5 9 18 18 5 8 15 10 15
14 19 15 12 14 19 9 17 16 11 12 10 14 19 6 17 16 11 20 20 6 11 12 16 19 19 6 17 16 11 19 16 18 4 17
7 10 10 8 8 16 15 16 6 6 14 10 15 10 8 15 10 15 8 14 10 15 8 14 10 15 10 14 6 8 14 16 8 10 15 10 6 14
20 18 9 6 4 11 6 4 16 6 4 9 6 9 6 4 16 6 9 6 4 16 6 9 6 4 16 6 9 6 4 16 6 4
11 10 9 4 10 9 10 9 12 10 9 10 9 10 9 10 12 10 9 10 9 10 12 10 9 10 9 10 4 10 9 10 9 10
32 39 44 7 8 16 37 44 20 27 16 29 4 30 39 39 34 37 18 31 27 16 10 29 5 21 22 39 37 18 30 27 16 10 29
18 15 17 16 9 8 18 6 4 4 9 10 18 10 9 4 16 7 18 18 11 9 7 18 6 10 9 4 18 10 9 4 18 6
20 10 18 19 17 7 18 10 12 17 12 22 7 18 10 12 17 12 22 7 19 10 18 20 10 12 22 7 18 10 12 17 12 22 7 12
12 10 12 13 11 5 6 9 6 9 6 9 6 11 5 12 12 9 6 11 5 9 6 9 6 11 5 12 12 9 6 11 5 9 6
4 7 11 4 9 4 5 4 7 4 8 11 4 7 4 11 4 7 4 8 11 4 7 4 8 11 4 7 4 8 11 4 7 4
13 7 13 12 5 18 23 11 15 6 12 19 16 13 14 22 15 17 14 22 15 17 4 16 15 17 14 22 15 17 14 22 15 6
26 30 29 33 32 13 16 32 13 33 29 13 33 32 13 33 29 32 13 33 23 29 32 13 33 23 29 32 13 33 29 32 13 16
24 10 41 19 20 28 50 21 49 23 35 48 22 46 8 27 12 34 32 38 36 47 44 42 8 17 18 5 37 27 42 14 13 11 29 15 45 39 31 33 33 11 24 30 26 9
6 20 20 16 19 17 4 5 9 12 19 9 12 19 9 12 6 20 15 12 7 9 9 12 19 9 12 19 9 12 6 20 15 12 19 9
10 9 5 13 13 13 17 17 17 7 5 13 13 13 17 17 17 10 6 9 13 13 13 13 17 17 17 7 9 13 13 13 17 17
12 14 17 10 13 8 11 20 15 12 4 19 6 5 9 16 18 12 4 19 6 20 9 16 18 12 4 19 6 5 9 16 18 12
11 4 11 10 14 13 4 10 14 13 4 10 14 13 4 10 14 13 11 10 4 14 13 4 10 14 13 4 10 14 13 4 14 13
33 20 17 36 42 27 39 23 36 42 25 44 44 48 52 8 32 10 27 39 23 29 5 30 38 6 49 28 40 15 30 9 45 27
34 6 4 42 31 18 46 5 31 6 31 42 31 36 31 6 12 4 46 5 18 6 31 42 31 9 6 31 6 14 46 36 42 31
6 7 7 8 4 4 5 7 7 7 4 4 5 7 8 7 4 4 5 8 8 7 4 4 5 8 8 7 4 4 5 8 8 7
15 10 16 12 13 13 6 6 7 15 15 6 7 15 15 15 12 12 13 13 10 16 15 6 13 13 6 7 15 15 7 15 15 7
6 6 6 6 6 6 6 6 6 6 6 7 7 1 7 1 7 1 7 1 7 1 7 7 1 7 1 7 1 7 1 7 1 7
20 15 5 9 10 22 7 23 19 4 14 15 9 10 22 7 23 19 4 14 15 9 10 22 7 23 19 4 14 15 9 10 22 7 23 19 4 14 15 9
5 5 21 4 16 7 20 12 21 9 11 19 15 28 21 11 19 28 28 21 11 19 15 28 21 11 19 28 15 28 21 11 19 28
13 10 11 11 6 15 15 15 12 11 11 13 15 13 15 9 11 11 11 13 15 15 13 12 11 11 11 13 15 15 13 12 11 6
6 10 15 5 12 12 16 15 8 6 15 8 6 15 8 16 15 8 16 15 8 16 15 8 16 15 8 16 15 8 16 15 8 6
4 17 17 9 9 9 8 12 5 21 4 19 11 10 20 9 14 13 6 4 19 11 10 20 9 14 5 6 4 19 7 10 20 9 14 9 6
8 5 4 7 7 7 5 5 4 4 7 1 5 5 4 4 7 6 5 5 4 4 7 6 5 5 4 4 7 6 5 5 4 4 7 6 5 5 4 4 7 6 5 5 4 4 7 6 5 5 4 4 7 6 5 5 4 4 7 6 5 5 4 4 7 6 5 5 4 4 7 6 5 5 4 4 7 6 5 5
16 13 23 24 19 32 19 24 19 12 32 26 29 27 36 9 21 7 31 38 18 39 22 6 30 15 17 14 17 10 34 28 4 8 35 31 37 41
29 4 20 17 14 16 18 29 21 18 29 21 25 22 27 16 18 29 21 25 14 18 29 21 28 22 16 27 22 29 21 25 14 18 29 21
22 23 13 27 34 22 32 25 25 7 15 32 18 29 18 19 21 14 11 7 5 8 26 30 9 16 6 24 10 12 28 25 14 17
10 5 5 9 4 6 4 6 9 7 5 10 7 8 11 6 9 7 7 5 7 10 4 11 9 9 8 11 9 7 5 7 10 8 11
18 17 15 8 16 10 14 6 4 5 19 14 8 8 19 19 17 13 19 8 8 19 14 6 18 5 19 14 8 8 19 19 17 13
5 20 21 6 12 12 22 10 14 11 13 20 21 22 12 5 4 13 16 22 9 14 11 11 11 20 21 22 12 5 4 13 16 22 9 14 11 10
46 45 23 44 8 16 6 18 22 21 10 33 29 54 43 27 7 28 49 22 33 34 27 5 43 52 38 30 51 14 48 15 20 39 19 41 44 31 53 36 9 24 49 11 35 26
9 38 47 6 27 27 47 43 46 38 43 22 35 22 36 32 19 35 22 5 36 32 11 24 24 26 47 14 36 32 11 24 24 26
15 20 9 20 7 9 9 11 7 9 9 13 14 7 17 11 7 17 9 11 7 17 9 11 7 17 11 7 17 9 13 11 7 10
10 5 9 4 10 12 7 13 8 6 6 10 12 7 13 8 5 6 10 10 4 5 12 7 13 8 6 6 10 12 7 13 8 5
7 14 16 4 11 17 8 12 14 10 6 12 14 11 10 17 10 4 17 10 4 16 6 9 14 10 10 15 16 6 12 17 10 10
29 6 18 11 11 4 24 10 15 30 26 33 21 30 22 5 20 20 8 8 27 19 4 30 10 30 10 31 24 7 20 20 8 8 27 19 4 30 10 30
9 7 16 19 17 15 18 16 19 6 12 10 15 10 15 18 16 19 19 18 16 6 7 10 15 10 15 19 18 18 16 9 7 19 10
11 11 15 5 18 7 17 15 18 7 5 17 15 18 7 5 17 15 18 7 5 17 15 18 7 5 17 15 18 7 5 13 17 15 18
8 17 7 6 4 11 14 13 7 6 4 9 6 8 13 7 6 4 11 8 13 7 6 4 9 6 8 13 7 6 4 11 8 13 7 6 4 9 6 8 13 7
8 8 6 16 11 7 17 12 8 4 9 15 7 17 12 8 4 9 15 11 17 12 8 4 9 15 7 17 12 8 4 9 15 14
7 15 21 6 6 22 19 24 14 12 22 21 6 19 22 4 5 14 14 15 6 22 21 6 22 12 22 21 14 22 21 6 22 12
22 8 10 10 31 7 4 12 35 34 7 4 30 11 11 37 8 12 35 13 17 10 4 35 34 15 4 30 12 37 16 32 15 4 30 17 37
9 9 14 12 13 4 5 8 8 9 11 5 12 4 5 5 12 5 13 4 5 5 12 12 5 13 4 5 8 8 9 14 12 4
49 11 36 42 44 33 17 16 18 34 56 9 27 24 43 53 52 6 25 39 21 29 29 53 52 38 39 21 43 43 53 52 8 25 39 21 29
8 6 11 7 12 14 4 5 9 6 4 5 9 6 11 7 10 14 4 5 9 6 4 5 9 6 11 5 6 14 4 5 9 6
5 8 8 9 13 7 13 5 4 8 9 13 10 13 5 4 8 9 13 10 13 5 4 8 9 13 10 13 5 4 8 9 13 10
16 12 42 9 24 9 17 38 46 16 45 39 46 16 45 34 30 19 29 32 36 28 42 24 24 9 17 38 46 16 45 39 46 45 34 30 19 29
7 7 11 4 4 7 7 7 11 4 4 7 7 11 4 4 7 7 11 4 4 7 7 11 4 4 7 7 11 4 4 7 7 11
7 11 6 10 4 9 4 7 11 6 10 6 10 6 7 11 6 10 6 10 4 7 11 4 10 6 10 6 7 11 6 10 6 9
13 8 7 18 4 14 12 12 15 16 9 6 17 17 11 18 4 14 11 11 18 4 7 18 16 9 6 5 17 11 18 4 14 11 11 18 4 7 18 16 9 6 17 17 11
18 9 9 13 25 22 19 21 6 9 24 10 12 12 26 7 4 14 5 15 17 10 16 12 12 12 13 25 22 19 5 15 17 10 16
9 18 8 10 5 21 6 15 21 4 20 19 14 7 15 11 11 6 22 22 13 12 6 19 14 7 15 12 11 6 22 22 13 12 6
7 10 11 6 11 11 8 11 7 7 11 11 8 11 11 6 11 11 11 6 11 11 11 6 11 11 11 6 11 11 11 6 11 11
6 6 7 13 9 16 8 6 14 10 4 13 16 8 6 14 10 4 13 16 8 6 14 10 4 13 16 8 6 14 10 4 13 16
22 11 15 21 11 15 21 11 15 21 11 14 13 4 4 22 9 11 11 15 21 11 15 21 11 15 21 22 14 4 13 9 4 21 11
16 26 13 7 13 28 4 4 4 4 4 4 4 4 4 4 4 4 4 4 4 4 4 4 4 4 4 4 4 4 4 4 4 4 4 4 4 4 4 4 4 4 4 4 4 4 4 4 4 4 4 4 4 4 4 4 4 4 4 4 4 4 4 4 4 4 4 4 4 4 4 4 4 4 4 4 4 4 4 4
18 12 7 11 4 6 6 5 13 24 13 6 6 5 18 18 12 7 11 24 6 6 5 14 4 5 18 12 7 11 24 6 6 5 14 4
30 5 13 14 22 8 27 8 12 22 29 16 11 24 15 29 16 11 15 31 6 5 25 12 22 29 28 11 24 15 31 6 5 18 11 15 31 31
15 11 4 8 5 18 7 6 12 13 16 14 9 11 5 16 14 9 17 17 7 6 12 13 16 14 9 11 5 16 14 9 17 5
9 13 16 12 15 14 4 10 4 14 7 10 4 12 15 14 11 10 4 12 15 14 11 10 4 12 15 14 11 10 4 12 15 12
25 29 14 26 10 11 28 28 24 29 26 14 26 14 24 29 26 26 28 15 9 28 24 29 26 14 26 24 29 26 26 28 28 32 9
6 15 10 5 18 4 7 14 9 8 12 16 17 11 15 16 17 11 13 16 17 11 15 16 17 11 15 16 17 11 13 16 17 11 13
9 10 5 7 12 12 7 12 12 7 12 12 12 7 12 12 12 7 10 4 12 12 7 10 4 12 7 12 12 7 12 12 7 10
22 45 35 28 60 31 40 61 50 6 63 14 50 6 63 14 57 35 10 46 32 22 8 4 14 49 35 33 69 31 7 61 29 14 57 14 49 21 48 35 43 20 41 23 39 51 9 12 17 42 44 37 14 54 14 49 25 48 21 31 7 61 29 14 54 35 57 35 49 61 48 39 51 45 13 44 17 42 13
8 12 10 6 17 6 17 4 13 15 8 10 12 8 10 12 8 4 16 17 4 16 17 4 13 12 8 10 9 8 10 9 8 4
16 36 38 34 23 25 31 27 25 39 43 10 9 41 6 5 12 29 27 28 10 48 50 22 6 17 14 32 46 5 22 4 11 24 8 20 7 30 26 40 45 21 16 15 16 21 35
9 5 14 14 10 13 10 11 13 4 7 11 13 4 7 11 13 7 4 7 11 13 4 7 11 13 4 7 11 13 4 7 11 13
8 9 6 7 10 5 4 7 10 5 4 8 9 6 7 10 5 4 8 9 5 8 7 10 5 4 8 9 5 8 7 10 6 4
27 4 4 25 12 49 40 9 42 15 44 9 58 6 45 19 40 15 44 52 40 9 42 15 45 19 20 39 19 35 15 44 52 49 35
4 8 19 15 7 11 14 9 5 18 12 9 18 12 18 17 8 15 15 11 5 18 12 9 11 8 4 15 5 18 12 9 11 8 4
11 4 8 10 10 9 16 12 9 12 9 12 9 12 9 12 9 12 9 12 9 12 9 12 9 12 9 12 9 12 9 12 9 12 9 12 9 12 9 12 9 12 9 12 9 12 9 12 9 12 9 12 9 12 9 12 9 12 9 12 9 12 9 12 9 12 9 12 9 12 9 12 9 12 9 12 9 12 9 12
36 17 60 24 31 39 23 10 46 36 48 63 46 36 48 44 4 41 7 58 68 49 9 25 20 40 43 8 33 6 69 30 19 28 49 9 51 4 41 7 68 11 25 20 40 43 8 33 17 28 69 30 19 28 49 4 51 27 41 7 68 11 25 20 40 43 8 33 17 28 69 30 19 28 49 9 51 4 41 11
12 13 13 11 10 8 4 4 10 8 14 9 6 12 14 15 6 12 14 15 6 4 4 13 14 9 8 4 4 10 8 8 4 13 14 9 6
12 7 13 14 6 13 10 13 14 6 12 4 4 12 13 14 6 12 13 10 13 14 6 12 4 8 12 13 14 6 13 10 13 14 6 12 13 10 6
4 13 12 14 11 8 14 11 8 4 12 14 11 8 4 12 14 11 5 4 12 14 11 8 4 12 14 11 8 4 12 14 11 8 4
16 16 10 17 9 12 11 18 8 21 20 15 11 18 8 21 13 14 19 8 21 16 22 11 17 8 21 20 8 21 12 7 11 18 19 8 23 16
24 8 22 24 11 4 23 6 19 18 27 13 14 26 12 17 20 25 5 9 25 21 6 16 17 20 25 25 5 13 14 26 16 17 20 25 5 9 15 21 7 16
8 7 4 12 6 10 11 5 7 11 5 7 11 5 7 4 11 10 11 5 7 4 11 10 11 5 7 11 5 7 11 5 7 12
5 5 4 4 4 4 1 4 4 4 1 4 4 4 4 4 4 4 4 1 4 4 4 4 4 4 4 4 4 4 4 4 4 4
5 14 9 13 4 4 13 4 13 4 4 13 4 13 4 4 13 4 13 4 4 13 4 13 4 4 13 4 13 4 4 13 4 13 4 4 13 4 13 4 4 13 4 13 4 4 13 4 13 4 4 13 4 13 4 4 13 4 13 4 4 13 4 13 4 4 13 4 13 4 4 13 4 13 4 4 13 4 13 4
23 31 40 8 10 21 6 43 9 44 32 13 9 44 17 13 9 16 16 16 16 39 39 25 22 14 17 5 17 5 32 41 33 16 16 16 16 39 39 25 22 14 17 5 17
8 15 21 15 9 7 11 18 25 10 12 29 20 4 14 16 27 13 23 14 22 6 28 28 28 28 23 7 11 5 10 12 29 20 4 14 16 27 11 23 14 22 6 28
11 17 25 29 34 19 28 9 32 10 18 32 10 24 28 10 18 7 7 7 18 28 10 29 24 28 31 24 7 18 7 10 18 7 9
21 7 12 5 15 10 9 16 17 6 4 24 19 21 20 12 8 8 13 18 18 4 12 8 21 20 12 8 8 19 18 5 12 6
20 20 18 4 14 5 19 10 10 11 13 17 6 6 16 14 5 19 16 16 14 5 4 14 13 7 8 16 14 5 19 16 16 14 5 4 14 13 7 6
8 5 10 13 10 11 13 11 8 5 12 13 10 4 13 8 8 5 10 13 10 11 13 10 11 13 12 11 13 12 11 13 12 11 13
18 8 4 15 19 12 24 10 10 19 12 5 20 8 17 13 24 24 10 19 12 5 20 8 17 13 24 24 10 19 12 5 20 8 17 13 24 24
19 12 12 5 20 8 21 15 10 10 8 21 15 20 12 19 12 15 20 22 4 12 21 15 20 8 21 15 20 4 12 21 15 20
8 27 22 27 9 4 17 16 27 13 5 10 18 28 21 26 30 17 12 21 14 24 14 24 11 19 11 19 19 26 25 9 13 5 10 18 28 31 26 30 15 12 31 14 24 14
22 33 4 25 20 30 26 22 33 13 16 36 21 28 24 28 5 6 9 15 33 13 16 36 36 18 15 17 29 35 27 5 5 9 6 33 13 16
4 8 5 5 9 9 4 8 14 4 4 9 12 9 9 9 4 8 14 4 4 9 9 12 9 9 9 4 8 14 4 4 8 5
14 14 12 12 10 8 9 9 9 9 14 9 4 4 12 8 14 9 9 14 12 12 12 8 9 9 9 14 9 12 12 4 8 14 9 9 14 12 4
8 34 43 6 49 30 17 16 44 21 13 39 33 12 25 19 26 15 5 46 39 32 19 41 25 11 47 27 29 19 41 38 9 10 40 18 22 37 23 35 35 48 8 14 51 42
25 9 9 31 29 31 14 14 22 22 22 18 18 8 17 32 6 31 12 21 29 31 14 31 22 14 22 22 22 18 18 7 17 33 9 9 9 31 29 31 14 14 31 22 22 22 18 18 7 17 33 6 31 12 5 29 31 14 31 22 22 22 22 18 18 7 17 33 9 9 9 29 31 31 14 14 31 22 22 22
4 8 6 5 7 7 7 7 7 7 7 4 4 6 4 6 8 7 7 7 7 7 7 7 4 4 6 4 6 5 7 7 7 7
4 6 10 11 11 11 12 4 4 4 6 10 11 11 12 4 4 6 10 11 12 11 4 4 6 12 11 10 4 4 6 12 11 11 10
10 9 7 20 7 20 16 20 20 16 23 9 7 23 20 9 7 11 20 20 7 11 20 16 23 10 7 23 20 7 11 20 20 7 11
11 11 17 4 14 5 4 12 15 7 18 20 22 13 19 21 8 23 16 17 19 8 23 13 20 19 21 8 23 18 17 19 8 23 13
14 5 17 10 5 17 16 15 20 20 5 17 10 5 17 16 15 10 5 17 16 15 10 16 17 16 15 10 5 17 16 15 10 16 17
23 23 11 8 12 9 18 20 27 9 5 19 14 17 27 7 25 12 11 19 14 17 20 25 12 7 5 18 20 8 14 14 27 9
52 31 36 28 11 65 40 30 44 30 4 30 27 64 48 37 37 33 15 5 14 67 57 14 9 30 4 30 66 68 14 33 32 37 60 56 46 37 60 42 66
5 4 9 7 7 4 4 4 4 4 7 4 4 4 4 7 7 4 4 4 4 7 4 4 4 4 7 4 4 4 4 7 4 9
18 11 11 7 12 8 9 15 15 12 8 7 17 10 13 17 15 12 8 9 16 15 12 8 7 17 10 4 17 15 12 8 9 16 15 12 8 7 17 10 13 17
8 9 4 7 4 6 13 7 4 7 4 7 6 13 6 8 14 8 13 14 8 5 8 5 8 14 6 8 14 14 8 5 12 5
20 15 10 20 22 18 10 7 5 21 17 22 9 13 4 9 24 25 12 9 24 25 12 7 13 25 11 15 22 7 13 25 11 15 19
