4 16 23 7 7 10 14 15 11 10 14 15 16 18 23 19 20 21 16 23 24 7 24 7 24 7 24 16 23 24 7 24 24 16
4 7 8 21 16 17 18 16 17 19 21 21 24 27 7 12 10 19 14 19 7 8 14 12 14 19 8 14 12 14 19 8 14 8
4 21 29 29 29 14 15 16 17 23 22 17 23 22 17 23 22 17 23 22 17 23 22 17 23 22 17 23 22 17 23 22 17 23 22 17 23 22 17 23 22 17 23 22 17 23 22 17 23 22 17 23 22 17 23 22 17 23 22 17 23 22 17 23 22 17 23 22 17 23 22 17 23 22 17 23 22 17 23 22
4 6 16 12 13 14 15 7 18 19 22 23 20 10 25 24 25 20 10 31 32 33 34 34 33 34 31 30 10 33 34 34 33 34
4 5 5 6 7 8 9 10 11 12 8 13 14 15 17 22 17 15 23 15 17 22 23 15 17 10 11 13 6 14 15 17 25 17 5 20 15 24 17 22 20 15 17 10 11 13 6 14 15 17 25 17 5 20 15 24 17 22 20 15 17 10 11 13 6 14 15 17 25 17 5 20 15 24 17 22 20 15 17 10
4 6 8 36 9 10 11 30 13 14 10 11 30 13 14 10 15 16 17 18 12 31 25 6 8 36 38 31 14 34 37 38 17 25
4 7 6 7 7 21 15 17 7 7 11 10 10 13 18 14 19 26 23 22 20 26 6 22 7 6 7 7 7 11 10 13 18 14 19 26 23 22 6 7
4 14 10 24 21 23 20 22 19 32 46 35 13 17 45 34 39 40 40 39 40 46 45 47 40 40 47 40 46 39 40 38 46 47 40
4 6 7 8 9 12 7 14 15 16 18 19 16 18 15 24 25 26 27 28 29 30 31 32 33 34 36 35 36 37 36 35 36 37
4 16 7 6 7 9 21 21 6 13 9 7 9 21 6 13 9 7 9 21 6 13 9 7 9 21 7 9 18 9 7 9 21 7
4 59 38 25 19 20 29 38 38 33 38 20 29 38 38 11 38 11 38 20 29 38 38 12 38 8 38 7 41 47 44 42 46 48 50 48 50 24
4 9 8 10 13 6 8 10 9 6 8 10 9 6 8 10 9 6 8 10 9 6 8 10 9 6 8 10 9 6 8 10 9 6 8 10 9 6 8 10 9 6 8 10 9 6 8 10 9 6 8 10 9 6 8 10 9 6 8 10 9 6 8 10 9 6 8 10 9 6 8 10 9 6 8 10 9 6 8 10
4 14 11 7 10 5 10 11 8 5 13 6 20 13 19 20 27 19 20 22 10 11 8 20 13 19 5 26 10 11 8 17 13 19 5 12 11 8 20 13 19 9 10 11 8 20 13 19 5 10 11 8 20 13 19 9 10 11 8 20 13 19 9 10 11 8 20 13 19 9 10 11 8 20 13 19 9 12 11 8
4 32 6 7 8 14 10 18 19 20 26 25 24 27 31 30 31 34 15 34 33 14 7 34 16 14 16 15 11 13 15 15 11 15
4 9 7 8 6 10 11 12 13 14 15 16 17 18 19 20 18 22 23 24 25 26 27 28 29 30 31 32 33 34 35 24 28 31 32 33 34 35
4 5 11 75 17 25 23 24 39 32 42 44 43 75 53 8 48 64 63 8 48 19 85 93 56 73 89 90 78 77 73 89 75 94 77 73 89
4 8 7 8 9 10 12 16 19 20 21 22 23 24 17 18 25 23 24 25 42 44 40 46 32 33 34 35 36 37 38 39 48 41
4 6 9 5 6 9 5 6 9 8 5 5 9 8 6 9 8 9 6 7 11 12 7 9 12 9 6 7 9 12 7 9 12 7
4 5 5 7 27 8 13 14 15 16 37 18 19 20 21 22 21 24 5 20 21 37 19 39 26 27 39 30 31 34 39 16 12 37
4 5 8 8 5 10 9 10 10 5 10 9 10 10 5 10 9 10 10 5 10 9 10 10 5 10 9 10 10 5 10 9 10 10 5 10 9 10 10 5 10 9 10 10 5 10 9 10 10 5 10 9 10 10 5 10 9 10 10 5 10 9 10 10 5 10 9 10 10 5 10 9 10 10 5 10 9 10 10 5
4 6 7 6 9 10 11 12 13 23 17 18 19 20 22 24 25 9 26 9 22 26 9 22 7 22 23 25 26 17 7 22 9 22
4 33 9 33 9 10 13 12 13 12 18 32 20 38 31 21 22 30 24 25 36 27 28 27 28 32 20 38 20 36 20 38 20 38 8
4 16 15 14 15 5 17 5 8 9 8 10 11 7 22 10 27 28 29 19 18 21 22 15 21 27 29 28 29 19 27 15 16 17 15 16 17 27 28 29
4 9 6 21 6 9 8 14 17 15 11 18 12 19 19 19 18 19 19 19 9 21 22 21 9 9 14 8 14 17 15 11 18 12 19 19 19 18 19 19 19 9 21 22
4 7 8 9 12 14 15 11 9 13 13 13 5 22 23 5 22 5 8 9 12 14 15 11 9 13 13 13 5 22 23 5 8 9 12 11 14 22 13 15 19 23 17 21
4 6 30 7 30 11 10 12 13 9 15 19 18 17 16 25 38 29 22 26 22 29 7 37 35 30 23 34 23 32 7 38 32 40
4 25 33 8 7 7 8 7 27 7 10 7 7 7 7 7 7 23 7 8 7 8 7 7 10 7 8 7 7 27 7 8 7 7 27 7 8 7 7 23 7 8 7 7 27 7 8 7 7 27 7 8 7 7 27 7 8 7 7 27 7 8 7 7 27 7 8 7 7 10 7 8 7 7 27 7 8 7 7 7
4 6 23 8 7 8 23 8 12 13 14 15 16 17 18 19 19 8 28 26 23 7 26 7 26 23 7 26 23 7 26 23 12 13 14 15 16 17 13 18 19 19 8 7 26
4 5 5 9 10 11 26 11 13 14 15 12 16 17 18 34 20 22 21 23 23 21 22 20 21 23 14 13 14 15 12 16 17 34 20 22 21 23 23 20 21 22 20 21 23 14 13 14 15 12 16 17 19 20 22 21 23 23 20 21 22 20 21 23 14 13 14 15 12 16 17 19 20 22 21 23 23 20 21 22
4 21 9 16 9 6 9 6 9 6 12 8 6 16 12 14 12 8 6 14 12 14 19 23 27 23 6 6 6 6 23 6 16 6
4 7 31 27 19 8 27 19 10 25 8 7 19 29 31 26 31 27 19 29 31 27 24 29 31 27 24 29 31 27 24 29 31 27 24 29 31 27 24 29 31 27 24 29 31 27 19 29 31 27 24 29 31 27 24 29 31 27 24 26 31 27 19 29 31 27 24 29 31 27 24 29 31 27 24 29 31 27 24 29
4 7 6 5 8 9 18 19 20 21 22 25 26 24 25 26 27 31 10 15 31 14 21 27 31 14 30 28 17 29 30 31 32 21
4 9 10 13 12 13 14 15 16 17 18 8 20 20 20 15 16 17 18 8 20 20 19 9 20 15 16 17 18 19 20 20 19 9
4 10 10 7 8 9 6 11 12 13 14 15 16 17 18 19 20 21 22 24 25 26 27 28 29 35 30 31 32 33 34 35 36 37
4 6 25 9 15 27 7 5 28 12 16 17 18 19 20 21 22 30 24 15 24 25 32 31 28 29 30 28 31 23 26 28 7 23
4 29 29 6 7 9 22 10 12 13 11 14 15 17 16 21 22 23 26 19 26 19 24 26 23 23 26 19 26 19 26 19 26 24
4 20 13 48 71 13 30 32 28 29 32 33 34 38 37 38 39 40 41 42 77 50 68 53 77 50 68 53 51 73 76 58 73 58
4 7 17 20 21 7 21 17 22 21 7 20 21 17 17 20 21 17 17 20 21 17 20 21 17 20 21 7 20 21 17 20 21 7
4 15 8 9 16 11 10 13 12 13 14 11 10 9 7 7 12 13 14 11 10 9 7 7 12 13 14 11 10 9 7 7 12 13 14 11 10 9 7 7 12 13 14 11 10 9 7 7 12 13 14 11 10 9 7 7 12 13 14 11 10 9 7 7 12 13 14 11 10 9 7 7 12 13 14 11 10 9 7 7
4 18 9 45 31 32 39 36 37 33 38 34 40 42 42 28 25 49 56 52 9 12 14 56 47 56 47 56 14 56 47 56 16 56
4 32 6 44 23 43 16 19 17 18 20 25 21 22 24 38 10 36 29 47 48 11 51 47 42 48 11 51 44 42 40 50 51 15
4 11 6 8 8 9 11 14 15 15 17 18 16 19 20 21 12 19 20 21 6 8 8 9 9 21 12 20 21 6 8 8 9 9
4 5 17 7 8 9 18 7 8 9 18 17 13 12 13 14 15 6 19 8 17 18 7 18 6 6 8 17 18 7 8 6 17 6
4 55 39 44 29 43 55 47 47 57 59 55 47 47 49 7 59 55 47 47 49 63 59 55 47 47 49 7 59 73 75 51 70 73
4 5 6 15 12 13 14 15 16 17 18 19 20 18 19 22 23 24 25 26 27 28 29 30 31 32 33 36 36 38 37 38 8 38
4 5 5 5 5 5 5 7 7 7 7 10 10 11 11 12 5 5 5 5 5 5 5 5 5 5 5 5 5 5 5 5 5 5
4 6 15 34 36 39 42 11 47 29 14 32 16 17 18 19 20 21 22 23 24 25 26 10 52 28 48 14 52 9 40 42 68 69 10 74 68 69 71 58 62 60 61 64 67 68 69 10
4 28 16 13 10 15 14 16 16 32 28 33 24 28 33 24 32 6 33 24 28 33 24 32 33 28 28 33 32 22 33 24 28 33
4 20 24 10 16 8 9 12 11 14 15 10 16 8 12 15 9 14 11 16 10 16 21 22 4 20 24 23 21 22 4 20 24 16 21
4 8 6 19 8 25 10 11 12 14 15 16 17 26 15 16 26 17 21 22 23 24 25 24 20 8 9 24 20 24 25 5 13 10 11 12 14 15 16 17 26 15 16 26 17 21 22 23 24 9 24 20 8 9 24 9 24 20 5 13 10 11 12 14 15 16 17 26 15 16 26 17 21 22 23 24 9 24 20 8
4 7 9 6 5 8 9 5 11 12 13 14 15 16 17 18 9 18 6 5 9 14 6 5 9 14 15 18 5 9 13 14 15 16 17 18
4 6 11 14 32 40 11 17 18 19 17 20 22 21 20 22 23 22 13 21 20 22 23 22 13 21 20 22 23 22 13 21 20 22 23 22 13 21 20 22 23 22 13 21 20 22 23 22 13 21 20 22 23 22 13 21 20 22 23 22 13 21 20 22 23 22 13 21 20 22 23 22 13 21 20 22 23 22 13 21
4 42 8 44 8 11 12 13 23 24 14 24 35 30 31 44 28 29 30 31 44 37 29 30 31 44 40 41 42 43 44 44 43 44
4 7 6 5 8 9 10 11 12 14 5 6 5 8 9 10 11 12 14 5 6 5 8 9 10 11 12 14 5 6 5 8 9 10 11 12 14 5 6 5 8 9 10 11 12 14 5 6 5 8 9 10 11 12 14 5 6 5 8 9 10 11 12 14 5 6 5 8 9 10 11 12 14 5 6 5 8 9 10 11
4 7 59 26 34 40 9 14 44 20 22 100 34 40 9 14 44 26 104 72 44 44 71 40 9 14 26 32 22 100 71 108 9 14 44 26 46 46 47 49 48 47 51 66 13 85 82 83
4 17 11 18 11 7 8 7 9 10 11 12 16 15 16 17 16 17 11 11 12 15 17 16 10 11 11 12 16 15 17 16 10 11
4 13 13 28 21 31 32 33 30 62 50 51 55 52 47 40 56 46 62 50 51 55 68 53 60 40 28 86 49 100 76 106 107 76 12 89
4 8 6 29 8 9 27 11 12 13 14 15 16 9 18 20 23 21 22 8 27 16 9 27 12 13 14 23 15 16 9 18 20 21 22 23 6 29 8 7 21 22 23 6 18 20 19 21 22 8 9 27 23 12 14 10 13 16 9 27 23 12 14 27 16 18 20 21 22 23 6 7 8 7 21 22 23 6 18 20
4 9 5 10 11 12 13 14 15 16 17 18 19 21 21 8 23 24 7 26 27 28 33 34 35 36 37 38 39 43 35 36 37 38 39 43
4 6 7 22 6 10 11 12 13 14 15 16 17 25 12 13 21 20 21 20 24 25 11 7 25 16 10 24 11 24 11 25 7 25
4 8 10 7 8 12 15 16 14 18 17 22 23 24 25 25 27 30 29 33 31 32 9 30 7 5 12 15 7 24 25 25 31 30 29 33
4 25 31 40 42 41 40 45 46 44 43 44 51 49 51 52 53 54 54 46 52 53 54 54 26 39 54 46 52 53 54 54 26 17
4 10 7 6 9 10 11 12 10 15 14 16 15 22 23 24 25 26 27 28 29 30 31 32 38 34 35 36 37 42 43 40 41 42 43 44 45 46
4 9 20 7 9 19 7 9 13 7 9 13 7 9 13 7 9 19 7 9 13 7 9 19 7 9 13 7 9 19 7 9 13 7 9 19 7 9 13 7 9 19 7 9 13 7 9 19 7 9 13 7 9 19 7 9 13 7 9 19 7 9 13 7 9 19 7 9 13 7 9 19 7 9 13 7 9 19 7 9
4 6 7 8 9 10 11 12 13 14 15 16 6 16 12 19 9 10 11 12 20 19 9 10 14 15 16 12 20 19 9 10 10 14
4 26 26 26 26 26 14 10 11 13 9 14 15 17 18 19 20 21 21 11 19 13 9 14 15 17 18 19 20 21 21 11 19 13 9 14 15 17 18 19 20 21 21 11 19 13 9 14 15 17 18 19 20 21 21 11 19 13 9 14 15 17 18 19 20 21 21 11 19 13 9 14 17 18 21 20 21 26 26 26
4 7 8 9 10 11 12 15 18 21 15 18 21 18 19 18 21 20 15 18 18 18 18 18 18 18 18 18 18 18 18 18 18 21
4 18 8 9 10 12 11 15 13 17 18 19 20 21 22 18 20 22 18 19 20 21 22 18 24 19 20 22 18 24 18 6 24 18
4 6 11 8 9 18 19 7 21 13 36 15 18 19 20 27 29 30 31 34 35 36 38 39 40 42 44 45 44 41 31 51 52 52 34 42 36 44 51 19 44 43
4 18 6 20 6 9 10 11 12 13 14 15 16 17 18 15 10 17 18 18 7 21 22 23 24 25 26 27 28 29 23 26 27 28
4 6 5 11 12 21 13 14 15 16 24 19 20 23 20 24 5 26 29 5 27 28 29 30 26 29 27 28 29 30 31 29 27 28
4 14 20 20 19 20 20 14 20 20 20 14 11 19 20 14 20 20 20 14 11 15 15 18 19 20 19 20 20 20 14 11 19 20
4 26 7 8 22 11 13 14 12 15 18 17 18 19 16 16 19 16 26 17 18 19 16 16 19 16 17 18 19 16 16 19 26 22
4 40 11 15 59 61 21 23 18 54 28 54 32 35 63 19 50 35 65 63 19 50 59 66 65 63 19 50 59 66 65 63 19 50 59 66 65 63 19 50 59 66 65 63 19 50 59 66 65 63 19 50 59 66 65 63 19 50 59 66 65 63 19 50 29 66 65 63 19 50 59 66 65 63 19 50 59 66 65 63
4 6 32 9 10 13 34 10 34 8 9 10 21 18 16 20 25 29 30 30 10 13 34 34 9 16 16 16 32 16 34 9 16 34
4 6 33 8 6 13 9 37 8 14 18 22 23 24 25 26 28 24 28 32 7 34 40 45 42 43 42 41 42 40 43 42 40 11
4 6 7 8 9 10 11 12 13 14 16 16 17 6 19 18 19 21 22 23 25 25 22 23 25 25 12 14 13 14 16 17 6 19 18 19 21 22 23 25 25
4 21 7 22 23 6 6 7 23 23 7 23 7 23 6 7 23 23 13 11 10 12 13 14 22 16 18 6 21 23 19 19 6 23
4 6 21 18 6 7 7 7 19 12 12 14 17 13 15 16 17 13 15 14 15 16 17 13 15 14 15 16 17 13 15 14 15 16 17 13 15 14 15 16 17 13 15 14 15 16 17 13 15 14 15 16 17 13 15 14 15 16 17 13 15 14 15 16 17 13 15 14 15 16 17 13 15 14 15 16 17 13 15 14
4 7 6 35 23 8 28 26 26 7 6 8 8 37 38 39 35 21 37 7 8 38 39 35 16 18 17 20 17 19 34 35 26 21 37 23
4 16 23 23 23 23 23 23 23 23 23 23 23 23 23 23 23 23 23 23 23 23 23 23 23 23 23 23 23 23 23 23 23 23 23 23 23 23 23 23 23 23 23 23 23 23 23 23 23 23 23 23 23 23 23 23 23 23 23 23 23 23 23 23 23 23 23 23 23 23 23 23 23 23 23 23 23 23 23 23
4 8 6 10 5 18 6 10 5 11 9 10 15 17 18 21 21 24 22 23 24 22 7 10 23 22 24 22 10 23 22 24 22 10
4 12 6 5 8 9 10 17 9 14 13 15 14 21 22 23 24 25 26 27 28 29 34 35 36 37 38 39 40 37 38 43 44 45
4 12 6 10 8 7 12 9 11 8 13 14 15 16 18 17 15 18 17 22 23 20 20 24 6 23 25 23 13 24 10 24 7 24
4 13 14 10 11 27 26 14 15 16 17 18 17 18 9 21 11 13 26 14 7 26 23 12 31 9 7 31 7 26 28 29 14 11 24 30 14
4 7 7 8 9 10 11 12 15 14 27 37 6 49 43 37 21 39 61 62 63 64 64 56 57 37 55 46 61 62 63 64 64 64
4 25 7 45 22 17 7 12 25 27 32 25 26 28 27 29 31 34 35 36 38 37 38 32 25 17 45 22 17 45 25 27 32 25 26 29 28 31 34 35 36 38 37 38 32 25 17 45 10 17 45 25 27 32 25 26 29 28 31 34 35 36 38 37 38 32 25 17 45 16 17 45 25 27 32 25 26 29 28 31
4 5 23 9 10 20 21 22 6 24 25 26 29 28 29 30 40 26 29 6 34 35 36 9 13 17 18 25 26 29 28 29 30 23 26 29 18 34 35 36
4 23 7 7 11 6 8 7 11 6 7 11 24 17 18 15 13 14 18 17 20 19 10 22 23 24 27 26 8 8 21 10 22 25
4 9 7 8 6 10 10 11 13 35 15 17 16 19 18 19 17 18 19 17 9 25 22 24 35 24 18 19 17 18 19 17 9 25 22 24 35 24 18 19 17 18 19 17 9 25 22 24 35 24 18 19 17 18 19 17 9 25 22 24 35 24 18 19 17 18 19 17 9 25 22 24 35 24 18 19 17 18 19 17
4 12 8 8 17 14 10 29 16 14 15 20 19 20 21 24 10 29 26 12 8 17 17 29 17 29 17 29 14 14 10 29 26 12
4 54 17 31 32 19 14 34 35 22 23 18 16 22 35 38 54 23 16 19 23 35 17 23 16 23 54 54 54 54 54 54 54 53
4 5 13 15 8 14 11 18 6 24 22 23 27 28 25 29 32 31 33 34 30 32 33 31 34 30 29 32 31 33 34 30 32 33 31 34 29 30 32 33 31 34 30 29 32 33 31 34 30 32 33 31 34 29 30 32 33 31 34 30 29 32 33 31 34 30 32 33 31 34 29 30 32 33 31 34 30 29 32 33
4 6 6 8 9 10 28 37 13 6 15 34 16 18 17 19 33 21 42 38 29 22 22 25 57 25 26 32 11 37 13 59 61 63
4 6 8 6 8 7 12 13 14 15 16 19 7 20 15 21 20 8 7 20 8 7 20 15 10 6 8 7 20 15 8 7 20 8
4 5 18 19 20 33 14 15 16 17 18 19 20 21 22 23 24 26 24 7 30 31 32 8 30 32 8 7 33 7 8 7 32 8
4 34 48 29 10 16 38 40 15 37 38 20 48 5 13 10 19 16 19 33 9 14 29 16 38 37 38 48 5 19 10 19 16 19 20 21 14 29 22 38 37 38 48 5 19 10 19 16 19 20 9 14 29 16 38 37 38 48 5 19 10 19 16 19 20 21 14 29 22 38 37 38 48 5 19 10 19 16 19 20
4 22 14 13 17 14 8 28 6 27 17 14 27 28 6 27 17 14 27 28 6 27 29 14 27 28 6 27 17 14 27 28 6 27 17 14 27 28 6 27 17 14 27 28 6 27 17 6 27 28 6 27 17 14 27 28 6 27 17 14 27 28 6 27 17 14 27 28 6 27 17 14 27 28 14 27 17 14 27 28
4 14 16 31 14 22 23 24 25 24 14 23 22 22 10 23 24 39 14 25 54 28 35 15 54 11 47 13 14 15 17 11 33 47
4 52 23 24 9 31 27 21 22 29 36 34 35 36 37 7 34 47 51 36 37 34 35 36 37 15 21 22 29 36 34 35 37 36 44 34 37 36 37 35 37 21 22 29 36 34 35 37 36 7 34 37 36 37 35 37 21 22 29 36 34 35 37 36 7 34 37 36 37 35 37 21 22 29 36 34 35 37 36 44
4 18 19 20 14 18 7 20 14 7 17 18 9 11 13 12 10 12 13 7 21 20 21 17 14 17 7 17 14 17 7 17 14 17
4 8 8 10 11 12 12 25 8 18 19 22 21 19 22 24 25 17 30 16 32 33 34 14 38 36 34 17 30 8 15 10 11 12 25 27 37 14 36 34
4 11 10 11 9 11 22 10 9 9 15 13 13 18 19 17 15 18 19 20 22 22 22 7 11 11 22 22 7 11 11 11 22 7
4 5 10 19 9 17 18 12 13 21 22 31 23 24 25 26 27 28 29 30 32 33 34 35 36 37 41 40 41 39 40 41 40 39 22 40
4 7 8 12 13 14 8 14 15 19 17 17 16 18 20 28 29 27 26 25 33 32 40 41 42 41 42 12 44 35 40 41 40 41
4 6 16 21 22 22 8 7 11 9 10 10 11 12 10 15 15 6 16 18 18 18 18 22 8 7 11 9 10 10 11 7 10 9 15 6 15 18 18 18 21 22
4 8 13 7 5 13 23 11 5 6 7 5 6 11 5 6 15 14 16 17 18 20 21 22 24 22 6 24 10 24 7 24 13 10
4 11 21 18 19 21 20 18 22 31 24 31 10 29 31 27 17 29 31 6 6 27 17 31 7 31 26 27 29 17 29 24 31 27
4 9 10 18 19 20 21 22 23 24 50 33 37 51 46 34 45 49 34 36 45 44 50 47 40 41 45 44 42 43 40 41 45 44 38
4 9 7 8 6 10 11 13 14 15 16 17 18 22 23 19 20 25 26 27 28 29 30 31 32 33 34 36 35 36 37 28 32 33 34
4 6 14 14 8 9 10 8 9 10 8 10 14 12 13 6 12 13 6 14 6 10 9 8 9 10 8 10 14 13 12 12 13 6
4 9 10 6 9 10 9 10 9 6 20 10 9 10 9 6 20 20 5 6 20 20 1 4 9 5 9 6 20 6 20 6 20 17
4 6 5 6 21 26 41 33 69 35 45 77 19 43 35 45 77 19 58 7 31 77 19 58 7 31 77 28 58 16 31 77 19 58 16 31 77 19 58 16 31 77 19 58 16 31 77 28 58 7 31 77 19 58 16 45 77 19 58 16 31 77 19 58 16 45 77 19 58 16 31 77 19 58 16 31 77 19 58 16
4 5 6 7 8 9 10 11 12 13 14 15 16 17 18 19 20 19 20 21 22 23 24 25 26 27 28 29 31 32 33 33 34 23 27 31 32 33
4 22 9 7 22 6 10 11 12 13 14 15 16 17 18 17 22 21 8 21 24 26 30 27 22 28 24 25 26 30 27 22 28 24
4 9 11 12 14 16 21 22 23 24 13 26 29 5 33 32 28 28 31 34 6 35 11 8 14 16 17 31 28 6 29 14 29 9 11
4 22 22 11 12 10 16 17 14 15 13 15 16 17 31 21 31 31 27 31 9 7 22 9 7 27 31 31 27 27 31 9 22 9
4 7 7 11 9 10 12 13 12 13 9 12 13 17 17 17 17 0 4 7 7 7 9 11 10 12 13 12 13 9 12 13 17 17 17 7
4 6 7 43 9 61 11 12 13 13 16 17 19 18 41 25 25 26 41 25 6 7 43 9 36 56 36 41 47 45 62 41 61 55 43 53
4 88 20 17 11 22 21 25 24 23 92 26 27 32 33 92 26 27 38 33 92 26 27 32 33 92 26 27 38 33 92 26 27 38 33 92 26 27 38 33 92 26 27 38 33 92 26 27 32 33 92 26 27 32 33 92 26 27 38 33 92 26 27 38 33 92 26 27 32 33 92 26 27 32 33 92 26 27 32 33
4 9 9 6 8 5 6 8 5 19 15 13 12 16 17 18 19 20 22 23 24 25 24 17 26 21 22 23 24 25 24 17 18 19 20 22 23 24 25 17 28 31
4 14 20 25 26 29 30 28 17 27 31 32 33 33 50 21 50 21 50 21 66 45 64 47 48 49 50 45 47 9 66 9 49 50
4 9 7 8 9 10 16 11 12 13 14 15 18 22 23 20 19 25 8 26 40 41 30 31 32 43 34 35 36 45 38 39 45 49
4 6 22 10 11 12 14 15 16 19 18 17 20 19 20 11 10 11 17 18 19 20 17 23 30 24 31 29 30 26 27 29 30 26
4 8 7 8 9 10 11 12 13 15 24 15 16 17 24 17 22 23 25 26 27 28 23 25 27 28 28 22 23 24 25 26 27 28
4 10 10 11 12 13 14 15 16 17 19 17 19 16 15 17 18 17 19 10 13 30 27 32 33 23 31 39 29 30 27 32 33 34 8 9 40 41 42
4 6 19 8 6 8 11 9 10 14 13 14 15 16 16 12 11 9 10 14 13 15 16 16 14 12 15 16 16 19 21 6 21 6
4 22 22 69 82 56 10 24 79 6 25 26 72 64 32 36 40 37 24 14 42 75 64 48 48 72 65 64 46 67 74 70 70 73
4 5 6 7 8 9 10 11 12 13 11 12 10 11 12 13 17 18 19 20 21 22 23 24 25 26 30 29 28 29 30 29 28 29
4 16 7 11 9 12 14 6 10 14 6 20 16 20 19 7 18 19 20 6 19 16 20 19 7 21 19 7 18 19 7 21 19 7
4 71 18 35 20 56 57 52 24 41 45 11 18 16 15 51 52 18 19 57 20 56 35 80 68 74 70 61 45 68 69 76 61 78 68 74 64
4 103 33 30 125 53 127 99 18 58 94 18 34 117 18 58 10 20 21 16 85 93 103 24 87 110 102 93 102 63 127 74 92 9 130 92 24 130 92 29
4 29 12 7 8 9 10 11 12 15 23 17 18 18 23 14 18 23 31 32 33 6 32 33 31 32 33 31 32 33 31 32 33 31
