4 21 7 24 7 24 23 23 10 14 15 12 15 16 13 18 20 19 21 16 23 24 7 24 24 16 23 24 7 24 7 24 24 16
4 7 12 21 16 17 18 16 10 19 21 21 18 17 16 10 18 19 21 21 24 27 27 10 19 14 19 14 7 8 14 19 14 19
4 21 29 29 29 14 15 22 17 17 22 22 17 23 22 17 23 22 17 23 22 17 23 22 17 23 22 17 23 22 17 23 22 17 23 22 17 23 22 17 23 22 17 23 22 17 23 22 17 23 22 17 23 22 17 23 22 17 23 22 17 23 22 17 23 22 17 23 22 17 23 22 17 23 22 17 23 22 17 23
4 13 16 12 6 14 15 16 18 19 22 23 19 20 10 31 24 25 24 25 20 10 31 32 33 34 24 25 20 10 31 32 33 34
4 5 5 6 7 8 9 10 11 12 13 6 14 11 22 17 15 17 25 26 27 28 29 30 29 30 21 27 21 28 21 29 25 18
4 6 8 9 36 6 34 9 10 11 30 13 14 10 15 16 17 18 19 25 19 31 38 34 35 38 14 10 11 19 31 31 14 34
4 7 6 7 7 21 6 7 7 7 1 4 7 6 7 7 5 6 7 7 1 4 7 6 7 7 5 6 7 7 7 1 4 7 6 7 7 5 6 7 7 7 1 4 7 6 7 7 5 6 7 7 7 1 4 7 6 7 7 5 6 7 7 7 1 4 7 6 7 7 5 6 7 7 7 1 4 7 6 7
4 14 10 8 14 24 20 22 23 21 19 20 19 10 9 13 17 35 32 17 45 17 47 40 40 39 40 47 40 46 39 48 47 40
4 11 7 8 9 10 6 15 16 18 19 16 18 15 19 16 18 19 24 25 26 27 28 29 30 31 32 33 32 33 34 35 36 37
4 16 7 6 7 9 21 21 9 18 9 18 9 7 9 21 7 9 18 9 7 9 21 7 9 13 9 7 9 21 7 9 18 9
4 29 16 38 25 19 20 29 38 54 38 7 41 47 46 44 43 47 29 44 42 46 48 50 48 59 54 25 12 7 29 7 38 7
4 16 6 8 10 9 6 9 8 10 9 6 8 10 9 6 8 10 9 6 8 10 9 6 8 10 9 6 8 10 9 6 8 10 9 6 8 10 9 6 8 10 9 6 8 10 9 6 8 10 9 6 8 10 9 6 8 10 9 6 8 10 9 6 8 10 9 6 8 10 9 6 8 10 9 6 8 10 9 6
4 14 11 7 10 5 12 11 8 13 9 26 16 20 19 12 5 26 6 20 22 19 9 10 11 8 20 21 19 5 26 10 11 8 20 13 19 5 26 12 11 8 20 21 19 5 26 10 11 8 13 9 26 16 20 19 12 5 26 6 20 22 19 9 10 11 8 20 21 19 5 26 10 11 8 20 13 19 5 26
4 6 7 8 11 6 11 13 15 10 18 19 20 26 27 25 26 19 27 20 8 31 36 13 32 12 14 7 36 37 14 16 15 11
4 9 7 8 9 10 11 12 13 14 15 16 17 18 19 20 17 18 22 23 24 25 26 27 28 29 30 31 32 33 34 35 24 25 34 35
4 5 81 75 13 25 23 24 26 41 38 39 32 42 44 43 75 53 8 48 68 71 77 87 89 75 94 79 93 87 75 54 94 93 87 89
4 6 28 6 9 10 12 16 14 15 20 21 22 23 24 25 23 42 36 29 28 42 44 40 46 42 44 45 46 42 44 45 41 42 44 45 46 42 44 40 41 42 44 45 46 42 44 45 41 42 44 40 46 42 44 45 41 42 44 45 46 42 44 45 41 42 44 40 46 42 44 45 46 42 44 40 46 42 44 40
4 7 5 6 9 5 9 6 9 5 6 9 5 9 8 5 6 9 8 5 9 6 8 7 9 9 12 7 9 12 7 9 12 7
4 5 5 35 39 7 13 14 15 16 37 18 24 20 21 19 20 21 22 23 24 5 19 20 21 22 23 24 5 26 27 39 30 31
4 5 8 8 10 9 10 10 5 10 9 10 10 5 10 9 10 10 5 10 9 10 10 5 10 9 10 10 5 10 9 10 10 5 10 9 10 10 5 10 9 10 10 5 10 9 10 10 5 10 9 10 10 5 10 9 10 10 5 10 9 10 10 5 10 9 10 10 5 10 9 10 10 5 10 9 10 10 5 10
4 8 7 8 9 10 9 10 11 12 13 23 17 18 19 20 22 23 24 25 26 9 22 26 9 22 24 25 7 22 23 25 25 26
4 35 6 10 13 12 13 12 18 33 24 33 38 33 19 18 30 24 22 23 25 36 27 40 27 40 32 33 36 20 38 33 38 31
4 16 15 14 15 16 17 11 10 7 22 7 8 9 10 11 23 29 28 29 18 19 21 27 27 28 29 19 18 21 27 27 28 29
4 9 6 9 8 14 17 15 11 18 12 19 19 19 19 19 19 18 19 19 19 19 19 19 19 18 19 19 19 19 9 21 22 21
4 7 8 9 12 14 15 11 14 22 13 13 7 23 5 22 5 8 9 12 14 15 11 14 17 13 13 7 22 23 5 8 9 12 14 15 11 14 22 13 13 7 23 5 22 5 8 9 12 14 15 11 14 17 13 13 7 22 23 5 8 9 12 14 15 11 14 17 13 13 7 22 23 5 8 9 12 14 15 11
4 32 38 6 7 30 11 10 12 13 9 15 19 18 18 17 16 25 30 29 22 26 22 29 7 34 35 38 38 23 22 29 26 28 24 29
4 32 33 8 7 7 7 7 7 7 7 7 7 7 7 7 7 7 7 7 7 7 7 7 7 7 7 7 7 7 7 7 7 7 7 7 7 7 7 7 7 7 7 7 7 7 7 7 7 7 7 7 7 7 7 7 7 7 7 7 7 7 7 7 7 7 7 7 7 7 7 7 7 7 7 7 7 7 7 7
4 6 28 8 25 8 23 8 25 8 12 13 14 15 16 17 18 19 19 8 25 26 23 7 26 23 7 7 26 23 7 26 23 25
4 11 29 5 12 13 14 15 18 34 20 22 21 23 23 21 22 13 14 13 19 15 12 16 17 19 20 21 22 23 21 23 36 7 26 10 26 31 32 33 35 36 37
4 21 9 16 9 6 9 16 12 8 6 16 12 14 12 8 6 19 23 27 19 23 27 27 19 23 27 23 6 6 6 6 23 6
4 7 31 27 19 8 27 31 29 31 27 24 19 27 31 26 31 27 24 29 31 27 24 29 31 27 24 26 31 27 19 26 31 27 24 29 31 27 24 29 31 27 24 29 31 27 24 29 31 27 24 29 31 27 24 29 31 27 24 29 31 27 24 29 31 27 24 29 31 27 24 26 31 27 19 29 31 27 24 29
4 16 6 12 8 9 19 18 20 21 22 24 25 26 11 28 29 15 28 32 30 28 14 30 28 14 30 28 10 26 24 25 26 11
4 8 6 7 19 14 10 13 12 9 15 16 17 18 8 20 20 19 10 20 15 16 17 18 19 20 20 8 9 20 15 16 17 18 19 20
4 10 7 8 9 6 11 12 13 15 14 16 17 18 19 20 21 22 24 25 26 27 28 29 35 30 31 32 33 33 34 35 36 37
4 6 25 7 5 28 29 12 15 17 16 18 18 19 20 21 22 19 21 30 11 24 25 31 29 28 31 29 28 7 23 26 28 31 23
4 29 29 6 23 19 9 22 10 12 13 11 14 15 16 17 14 15 16 17 22 29 29 29 29 25 23 26 23 7 26 7 24 26
4 20 6 48 64 6 30 32 28 29 32 33 34 39 38 40 41 39 77 40 41 42 77 50 68 69 53 77 50 68 53 51 73 57 52 64 58 50 69 77 53 68 50 51 73 57 52 17
4 7 17 20 21 7 21 17 22 21 21 17 20 21 17 20 21 17 20 21 17 20 21 17 20 21 17 20 21 17 20 21 17 20
4 5 9 16 5 9 7 7 8 9 7 10 11 10 12 13 12 13 14 11 10 12 13 14 11 12 13 14 11 10 12 13 14 11 12 13 14 11 10 12 13 14 11 12 13 14 11 10 12 13 14 11 12 13 14 11 10 12 13 14 11 12 13 14 11 10 12 13 14 11 12 13 14 11 10 12 13 14 11 12
4 18 30 45 5 32 39 36 37 33 36 37 34 40 38 42 42 25 28 56 14 56 47 56 47 56 16 56 56 52 56 56 52 56
4 15 8 44 28 8 23 43 18 19 20 25 21 16 43 22 24 24 22 11 51 12 41 44 46 48 11 51 47 48 11 51 32 33
4 11 18 16 11 14 17 18 16 19 20 21 6 8 8 9 9 21 12 20 21 6 8 8 9 9 21 12 20 21 6 8 8 9
4 5 5 9 8 18 7 8 9 18 18 6 8 9 18 7 8 9 18 7 8 18 17 7 18 12 13 14 15 6 5 9 8 17
4 55 47 26 68 70 10 68 23 22 21 24 27 35 28 41 43 44 34 43 55 47 47 57 7 59 55 47 49 7 59 55 47 57 7 59 73 75
4 5 6 7 12 13 10 11 17 18 19 20 18 19 22 23 24 25 26 27 28 29 30 31 32 35 36 37 38 8 8 37 40 8
4 5 5 5 5 5 5 5 5 5 5 5 5 5 5 5 5 5 5 5 5 5 5 5 5 5 5 5 5 5 5 5 5 5 5 5 5 5 5 5 5 5 5 5 5 5 5 5 5 5 5 5 5 5 5 5 5 5 5 5 5 5 5 5 5 5 5 5 5 5 5 5 5 5 5 5 5 5 5 5
4 15 15 7 37 83 27 11 81 48 14 32 16 17 18 19 20 21 22 23 24 25 26 10 52 11 38 52 39 40 39 10 55 38 56 57 58 62 60 61 64 67 65 69 27 72 71 74 75 10 77 78 80 11
4 28 16 13 15 14 16 16 24 13 15 14 16 24 16 7 16 24 13 15 14 16 16 24 16 24 13 15 14 16 16 24 16 24 13 15 14 16 16 24 16 24 13 15 14 16 16 24 16 24 13 15 14 16 16 24 16 24 13 15 14 16 16 24 16 24 13 15 14 16 16 24 16 24 13 15 14 16 16 24
4 23 24 20 10 16 8 9 12 15 11 14 9 10 16 21 22 24 16 20 20 20 24 16 21 22 24 16 20 20 20 24 16 21
4 8 6 7 8 9 10 11 12 14 15 16 17 26 15 16 26 17 21 27 28 22 23 24 20 24 25 8 25 24 20 24 7 8 20 24 7 8 20 24 7 8 20 24 7 8 25 24 7 8 20 24 7 8 9 10 11 12 14 15 16 17 26 15 16 26 17 21 27 28 22 23 24 9 24 20 8 9 24 20
4 10 9 6 5 9 6 5 9 6 5 11 12 13 14 15 16 17 18 9 6 9 6 5 9 6 9 6 5 9 9 6 9 6
4 9 28 11 18 17 20 19 22 23 22 23 22 23 11 9 36 11 10 11 10 11 17 20 19 18 22 23 22 23 22 23 11 9 36 11 10 11 10 11 17 20 19 18 22 23 22 23 22 23 11 9 36 11 10 11 10 11 17 20 19 18 22 23 22 23 22 23 11 9 36 11 10 11 10 11 17 20 19 18
4 37 17 39 10 11 12 22 23 24 35 30 30 31 33 34 29 30 31 37 39 40 41 42 43 44 44 43 44 35 41 42 43 44
4 7 6 5 8 9 10 11 12 14 5 6 5 8 9 10 11 12 14 5 6 5 8 9 10 11 12 14 5 6 5 8 9 10 11 12 14 5 6 5 8 9 10 11 12 14 5 6 5 8 9 10 11 12 14 5 6 5 8 9 10 11 12 14 5 6 5 8 9 10 11 12 14 5 6 5 8 9 10 11
4 63 59 20 44 71 40 9 14 44 26 32 22 100 40 9 46 48 49 47 46 48 47 51 41 66 82 37 89 82 78 83 11 63 82 83
4 17 11 18 11 11 7 8 7 8 12 16 15 16 17 11 11 18 12 15 16 17 11 11 18 12 15 16 17 11 11 17 16 17
4 13 27 21 33 82 17 32 33 46 30 62 42 56 63 73 42 74 38 40 74 63 62 42 43 41 43 38 61 41 62 33 46 38 39 41 40 43 37 53 38 61 63 62 42 53 63 53 38 61 63 62 33 46 38 39 41 40 53 63 73 42 74 63 62 42 53 63 43 54 61 63 62 33 46 38 39 41 40 53
4 8 6 26 8 9 10 11 12 13 14 15 16 9 18 20 19 21 22 10 8 7 8 7 8 11 17 10 13 12 14 15 16 9 18 20 19 21 22 21 16 10 22 21 22 6 7 8 7 8 9 10 11 12 13 14 15 16 9 18 20 19 21 22 21 16 27 22 10 21 22 6 7 8 7 8 11 18 14 15
4 5 9 10 11 12 13 14 18 15 16 17 10 14 19 21 21 31 6 24 20 26 27 28 29 34 22 32 29 30 35 36 37 38 39 41 42 43
4 9 7 22 6 10 24 14 15 6 17 13 14 15 6 17 25 12 13 21 20 21 8 6 24 11 11 12 13 21 20 21 22 6 24 11
4 8 10 7 6 12 15 16 18 17 13 21 23 22 24 25 27 32 30 29 33 5 31 32 30 7 7 5 31 7 31 32 9 33
4 31 25 52 53 54 31 31 19 28 37 31 31 31 14 15 20 25 42 40 45 46 43 44 51 49 51 49 52 53 54 52 53 54
4 10 7 6 9 10 11 12 10 14 15 16 22 23 24 25 27 40 21 22 23 24 25 27 40 45 46 30 33 34 32 33 30 31 32 37 38 43 44 45 46
4 9 20 7 9 10 7 9 20 7 9 20 9 20 9 20 9 20 7 9 20 9 20 9 20 9 20 7 9 20 9 20 9 20 7 9 20 9 20 9 20 9 20 7 9 20 9 20 9 20 9 20 7 9 20 9 20 9 20 7 9 20 9 20 9 20 9 20 7 9 20 9 20 9 20 9 20 7 9 20
4 15 7 8 9 10 11 12 13 14 15 16 8 16 12 19 20 21 6 10 10 11 12 20 19 9 10 10 14 15 9 10 11 12 20 19 7 6
4 26 30 7 10 11 13 9 14 15 17 18 19 20 21 21 19 26 26 26 26 11 33 26 26 36 21 21 18 19 20 21 17 21 19 11 19 13 9 14 15 17 18 19 20 21 21 19 26 26 26 26 11 33 26 26 26 36 21 21 18 19 11 19 26 26 26 36 21 21 18 19 20 21 17 21 19 11 19 13
4 19 8 9 10 11 12 15 18 21 15 18 19 20 18 18 18 18 18 18 18 18 18 18 18 18 18 18 18 18 18 18 18 20
4 14 17 18 8 9 10 12 13 14 15 17 18 19 20 21 22 9 14 16 15 13 18 19 20 22 18 19 20 22 18 24 19 20 22 18 24 19 20 22 18 24 19 20 22 18 24 19 20 22 18 24 19 20 22 18 24 19 20 22 18 24 19 20 22 18 24 19 20 22 18 24 19 20 22 18 24 19 20 22
4 20 6 20 17 18 19 11 21 13 36 24 18 19 7 29 30 31 32 33 34 35 36 38 39 40 42 44 43 36 48 51 44 43
4 18 8 7 6 9 10 11 12 13 14 15 16 17 18 15 10 17 18 18 7 21 22 23 24 25 26 27 28 29 22 23 24 25 26 27 28 29
4 6 5 11 12 21 13 14 15 16 19 17 20 23 20 24 5 17 26 27 28 29 30 29 5 27 28 29 7 26 31 28 29 30
4 14 20 20 19 20 20 20 14 11 19 20 20 14 11 15 18 19 20 19 20 20 20 14 11 18 19 20 19 20 20 14 20 18
4 26 7 8 8 11 13 12 15 18 17 18 19 16 16 19 26 8 22 25 26 8 26 25 26 8 26 8 26 25 26 8 26 8
4 40 11 45 29 61 51 53 54 24 58 62 20 35 65 63 64 66 75 74 66 65 33 34 66 75 74 66 65 63 64 25 10 66 65 64 59 10 90 13 91 91 66 65 63 64 29 10 11 45 25 31 51 18 54 53 50 54 62 35 65 63 64 66 75 91 66 65 63 64 66 75 91 66 65 63 64 55 10 66
4 6 32 9 10 13 8 11 10 34 8 9 10 34 10 21 20 22 23 20 25 24 29 30 30 16 9 34 9 11 34 9 11 34
4 6 33 8 9 36 13 9 37 8 40 19 38 17 20 18 22 23 24 25 26 28 24 28 32 34 19 38 40 43 44 41 42 43 44 40
4 6 7 8 9 11 10 12 13 14 16 16 17 6 19 18 19 21 22 23 25 25 17 22 23 25 24 25 17 22 23 25 23 25
4 21 7 23 22 23 23 6 7 23 7 23 7 23 7 23 22 23 13 10 11 12 13 14 22 16 18 6 23 19 19 21 22 23
4 7 6 9 7 7 12 12 17 13 15 14 15 16 17 13 15 14 15 16 17 13 15 14 15 16 17 13 15 14 15 16 17 13 15 14 15 16 17 13 15 14 15 16 17 13 15 14 15 16 17 13 15 14 15 16 17 13 15 14 15 16 17 13 15 14 15 16 17 13 15 14 15 16 17 13 15 14 15 16
4 34 6 35 23 8 28 11 13 15 12 14 24 16 18 17 20 19 19 26 24 32 21 37 23 8 8 38 39 21 37 36 38 39
4 23 49 30 29 27 33 42 40 41 42 43 45 16 50 46 45 16 50 23 23 23 50 23 23 23 23 23 23 23 23 23 23 23 23 23 23 23 23 23 23 23 23 23 23 23 23 23 23 23 23 23 23 23 23 23 23 23 23 23 23 23 23 23 23 23 23 23 23 23 23 23 23 23 23 23 23 23 23 23
4 8 6 10 8 7 6 10 5 11 9 10 15 17 18 21 21 21 24 23 22 23 24 22 18 10 23 24 22 10 23 22 23 24
4 9 6 5 8 12 10 17 9 13 14 15 21 22 23 24 25 26 27 28 29 30 31 37 33 34 35 36 37 38 39 40 37 38 43 44 45
4 5 13 10 7 5 13 7 5 13 11 8 13 14 15 17 18 16 25 21 20 24 23 6 24 22 22 23 13 24 10 24 7 24
4 9 27 26 14 10 11 7 12 14 15 16 17 18 17 18 6 21 11 13 26 14 12 23 13 31 14 12 23 13 31 14 13 31
4 7 7 9 8 10 11 9 12 14 15 15 36 58 38 60 21 43 58 21 46 51 26 42 50 51 25 39 51 6 42 50 44 22 39 61 62 63 64
4 25 11 45 16 17 27 32 25 26 29 31 34 35 28 36 38 37 38 32 17 10 17 45 10 17 45 25 27 32 7 29 31 34 35 36 37 38 38 32 25 17 10 17 45 25 27 32 11 29 31 34 35 36 37 38 38 32 25 17 10 17 45 25 27 32 7 29 31 34 35 36 37 38 38 32 25 17 10 17
4 40 23 9 9 10 20 21 22 6 24 25 26 29 28 27 30 5 34 35 36 9 13 17 10 20 21 22 40 30 37 13 17 6
4 7 7 7 11 6 27 7 11 6 11 26 7 11 24 8 7 11 26 17 18 13 14 16 17 18 20 19 10 22 23 24 27 8
4 9 7 8 20 10 10 11 13 14 35 15 17 16 19 18 18 19 17 18 19 25 22 24 35 24 23 22 30 36 34 20 8 8
4 14 14 10 29 16 21 20 21 14 24 10 29 7 7 12 12 8 8 17 17 14 14 17 29 24 10 29 14 14 16 21 20 19 14 24 10 29
4 54 22 31 13 24 34 19 23 21 22 18 37 34 54 54 53 54 53 54 53 54 54 54 54 54 54 54 54 53 54 53 54 53
4 5 13 15 17 14 11 18 6 22 24 26 25 29 27 28 31 32 33 34 30 32 31 33 34 38 30 32 31 33 34 38 30 32 31 33 34 38 30 32 31 33 34 38 30 32 31 33 34 38 30 32 31 33 34 38 30 32 31 33 34 38 30 32 31 33 34 38 30 32 31 33 34 38 30 32 31 33 34 38
4 6 6 8 46 26 51 37 41 6 15 34 16 18 17 19 33 21 38 29 22 38 34 21 22 38 32 22 41 8 26 32 28 55 57 59 61 63 62 32
4 6 10 6 7 8 13 14 15 16 19 7 20 8 7 20 8 7 20 15 8 7 20 15 8 7 20 15 8 7 20 15 8 7
4 15 6 29 12 13 14 19 20 15 16 5 18 19 20 12 13 14 15 16 17 18 19 20 12 13 14 15 16 5 18 19 20 12 13 14 15 16 5 18 19 20 12 13 14 15 16 5 18 19 20 12 13 14 15 16 5 18 19 20 12 13 14 15 16 5 18 19 20 12 13 14 15 16 5 18 19 20 12 13
4 34 48 29 16 16 22 38 37 38 48 5 19 10 19 20 9 29 22 38 37 38 48 5 19 10 19 28 9 29 22 38 37 38 48 5 19 10 19 20 9 29 22 38 37 38 48 5 19 10 19 20 9 29 22 38 37 38 48 5 19 10 19 20 9 29 22 38 37 38 48 5 19 10 19 20 9 29 16 38
4 10 5 9 13 17 6 27 28 6 27 28 6 27 17 14 27 28 14 27 28 14 9 17 6 9 28 14 8 28 14 9 17 14 8 28 6 9 28 14 9 17 14 8 28 14 8 28 14 9 17 14 8 28 14 8 28 14 9 17 14 8 28 14 8 28 14 9 17 14 8 28 14 8 28 14 9 17 14 9
4 14 12 9 14 25 23 24 22 14 25 54 8 35 33 47 7 11 47 9 42 46 31 56 28 35 47 9 14 15 17 11 33 47
4 44 13 33 24 47 30 23 28 25 31 29 36 34 35 37 7 34 37 36 37 34 35 37 5 32 33 52 55 39 40 52 41 42
4 18 21 20 14 7 17 18 17 14 7 17 18 17 14 18 17 18 17 18 17 18 17 14 18 17 18 17 18 17 18 17 14 18
4 8 8 9 10 11 12 25 8 29 19 18 22 21 19 22 24 25 17 30 16 32 33 34 14 38 36 34 14 30 17 37 14 15
4 11 10 11 9 11 11 10 9 9 17 13 14 18 19 15 20 22 22 22 7 11 11 22 22 7 11 11 11 22 7 11 11 22 7
4 10 5 17 19 8 31 22 31 20 21 22 31 23 24 25 26 27 28 29 30 32 33 34 35 36 37 37 40 39 40 41 22 40
4 7 8 8 12 7 14 15 19 17 16 18 20 21 28 29 27 26 25 33 32 33 39 40 41 42 41 21 43 40 41 21 41 42
4 22 16 21 22 8 11 7 10 9 10 15 6 15 6 18 18 18 18 18 21 22 8 9 10 11 10 15 15 6 16 18 18 18 21 22
4 8 6 10 7 5 6 7 5 6 11 5 6 16 17 15 14 18 22 20 21 20 23 24 22 9 24 10 24 7 24 22 6 10
4 11 21 18 19 20 21 18 19 22 31 30 31 10 29 31 27 29 31 10 9 31 7 26 15 11 28 6 15 30 17 31 26 10
4 9 17 11 19 20 21 22 35 23 24 21 22 37 51 46 34 47 41 45 44 35 47 48 49 47 48 49 36 40 41 45 44 45 38
4 6 7 8 6 10 11 13 14 15 16 17 23 19 20 19 21 22 23 36 25 26 27 28 29 30 31 32 33 34 35 36 37 27
4 6 14 14 8 9 10 8 9 10 8 9 10 13 12 13 6 12 13 6 14 6 14 6 10 9 8 9 8 10 14 12 13 6
4 9 5 6 17 9 10 6 20 14 15 17 10 9 17 9 10 6 20 14 15 17 9 5 6 17 9 5 6 20 14 15 17 20
4 6 5 6 26 9 14 43 35 45 77 33 34 26 27 14 69 30 17 77 33 24 26 27 14 69 30 31 77 14 69 30 31 77 14 69 30 31 77 33 34 26 64 33 34 16 31 51 52 53 54 55 52 53 54 71 83 79 81 82 79 78 79
4 5 6 7 5 9 11 12 13 10 11 12 14 15 16 17 18 19 20 19 20 21 22 23 24 25 26 27 28 29 30 31 32 33 33
4 6 7 22 9 10 11 12 13 14 15 16 17 18 17 18 28 14 15 16 17 18 17 18 28 14 15 16 17 18 17 18 28 14 15 16 17 18 17 18 28 14 15 16 17 18 17 18 28 14 15 16 17 18 17 18 28 14 15 16 17 18 17 18 28 14 15 16 17 18 17 18 28 14 15 16 17 18 17 18
4 9 11 12 13 14 16 17 18 17 15 21 22 23 24 13 26 33 5 35 32 28 35 6 30 28 31 6 35 11 29 14 29 9 10
4 22 31 7 22 23 7 10 12 16 17 14 15 13 15 16 17 21 31 7 27 31 27 31 27 27 31 9 22 23 23 17 16 17
4 7 7 11 9 10 12 13 12 13 9 12 13 7 17 17 17 7 7 7 9 12 13 7 10 9 12 13 12 13 7 17 17 17 13
4 6 7 22 9 36 11 12 13 13 16 17 18 19 27 25 25 25 40 41 25 25 6 7 45 47 48 54 8 9 45 53 56 55 41
4 88 13 35 18 22 21 27 23 92 26 27 38 33 92 26 27 52 32 33 92 26 27 52 32 33 92 26 27 52 32 33 92 26 27 52 32 33 92 26 27 52 32 33 92 26 27 52 32 33 92 26 27 52 32 33 92 26 27 52 32 33 92 26 27 52 32 33 92 26 27 52 32 33 92 26 27 52 32 33
4 9 9 28 9 6 28 5 12 16 15 13 14 15 19 20 23 24 25 22 17 26 21 24 17 21 28 31 24 6 8 17 26 21
4 10 7 24 29 26 32 28 30 27 29 31 32 33 33 13 24 29 50 32 61 33 30 50 28 26 31 32 33 33 20 29 50 21 50 32 28 41 33 30 50 26 31 32 33 33 12 29 50 21 50 32 28 17 33 30 50 26 31 32 33 33 12 29 50 21 50 32 28 17 33 30 50 26 31 32 33 33 7 29
4 6 7 8 6 10 16 11 12 13 14 15 16 21 14 15 18 19 20 19 16 21 22 23 37 25 38 39 28 29 42 31 32 43 34 35 36 45 38 39 45 38
4 6 30 8 10 11 12 14 15 12 14 11 27 30 31 8 26 27 29 30 8 8 27 29 30 22 26 11 27 29 30 22 26 27
4 6 21 6 7 6 9 10 11 12 13 15 24 11 12 13 16 17 15 16 17 24 22 23 24 25 26 27 28 23 24 25 26 27
4 5 6 34 8 36 14 15 16 17 18 19 17 10 11 13 30 27 32 21 30 27 32 21 40 8 9 30 38 39 40 41 42 42
4 19 6 8 8 11 9 10 12 13 14 15 16 16 11 19 19 21 6 21 6 8 8 11 9 12 13 14 15 16 16 11 19 21 6
4 22 14 69 82 21 6 24 12 48 14 26 25 72 24 29 30 36 40 42 33 61 48 63 53 72 65 67 74 70 70 82 76 46 75 53 47 73
4 9 6 7 8 5 10 11 12 13 11 12 10 11 12 13 17 18 15 16 17 18 19 20 21 22 23 24 25 26 27 28 29 27
4 16 7 6 7 20 9 12 11 14 21 10 14 6 20 20 7 6 19 7 6 19 20 6 20 19 6 20 16 19 7 6 19 7
4 71 53 57 55 56 35 52 24 11 18 33 15 52 24 19 57 20 56 39 37 56 22 52 24 11 18 33 15 52 26 77 19 37 56 57 20 56 39 52 26 11 18 33 15 52 26 77 19 37 56 57 20 56 22 52 24 11 18 33 15 52 26 77 19 37 56 57 20 56 22 52 24 11 18 33 15 52 24 77
4 82 30 94 31 30 125 67 87 58 94 33 13 34 67 18 10 11 21 93 25 87 110 117 102 58 82 75 117 110 127 85 130 92 94 13 75 18
4 5 26 7 8 9 19 11 12 15 16 24 18 23 18 14 23 32 16 10 23 17 14 23 16 18 18 23 14 16 19 23 24 14 23 16 18 13 23 14 18 23 16 10 14 23 24 16 18 23 18 14 23 32 16 10 23 17 14 23 16 18 18 23 14 16 19 23 24 14 23 16 18 18 23 14 23 32 16 18
