4 21 7 7 7 10 11 10 14 15 12 15 16 18 7 19 20 21 21 23 24 7 7 24 16 23 24 7 7 24 24 7 24 16
4 7 12 12 16 16 17 18 16 17 19 21 21 18 17 19 21 22 14 19 14 19 14 27 27 27 14 19 14 19 14 19 14 8
4 21 29 29 29 29 29 29 6 21 29 29 29 29 29 29 29 29 29 29 29 29 29 29 29 29 29 29 29 29 29 29 29 29
4 13 16 12 6 14 15 7 14 31 18 19 20 22 23 25 24 25 20 22 23 25 24 25 20 10 31 30 33 34 34 33 34 31
4 5 5 6 8 13 14 11 22 9 10 13 14 11 22 17 15 17 5 10 11 13 6 8 9 10 11 22 17 15 17 15 17 22 20 15 17 22 11 8 13 14 11 22 17 15 17 5 10 11 13 6 9 10 11 12 8 13 14 11 22 17 15 17 22 23 15 17 22 11 8 13 14 11 22 17 15 17 5 10
4 6 8 9 11 12 13 14 10 15 16 17 18 22 20 23 22 24 25 30 31 38 38 34 6 8 9 36 34 17 17 25 12 13 14
4 7 6 7 7 7 7 7 7 7 7 7 7 7 11 10 10 13 18 14 19 23 22 20 7 7 6 7 7 6 7 14 20 22 20
4 14 10 24 22 23 21 20 22 19 19 10 12 46 35 35 37 38 39 40 40 46 38 46 39 40 40 46 39 40 40 46 45 47 40
4 6 7 8 9 10 7 14 15 16 18 19 16 25 22 23 24 25 26 27 28 29 30 31 32 33 33 35 36 35 36 37 36 35 36
4 16 6 7 9 21 9 6 13 7 9 7 9 6 13 7 9 21 9 6 13 7 9 7 9 6 13 7 9 21 9 6 13 7 9 7 9 6 13 7 9 7 9 6 13 7 9 7 6 13 7 9 7 6 13 7 9 7 6 13 7 9 7 6 13 7 9 7 6 13 7 9 7 6 13 7 9 7 6 13
4 29 38 16 20 29 29 38 38 37 20 29 38 52 41 47 44 42 46 47 44 43 46 48 50 59 20 29 8 38 7 37 54 47
4 13 8 10 13 13 16 6 8 10 13 13 16 6 8 10 13 13 16 6 8 10 13 13 16 6 8 10 13 13 16 6 16 19
4 9 11 7 10 9 10 11 8 8 9 8 20 22 19 9 12 11 8 8 9 8 20 22 19 5 26 12 11 17 22 8 5 26 8 20 22 19 20 22 12 5 8 8 20 22 19 5 26 10 20 22 8 9 8 20 22 19 5 26 10 11 17 22 8 9 26 8 20 22 19 20 22 12 5 8 8 20 22 19
4 6 7 8 13 6 9 13 10 18 19 20 26 25 27 20 26 19 27 31 30 31 36 15 32 33 14 7 34 35 16 15 11 15
4 9 7 8 6 10 11 12 13 14 15 16 17 18 19 20 17 18 22 23 24 25 26 27 28 29 30 31 32 33 34 35 24 25 34 35
4 5 51 75 13 25 23 24 32 42 44 24 39 32 42 44 24 43 8 48 7 53 16 85 77 73 89 90 94 79 93 73 75 94 69
4 8 28 8 9 10 19 16 19 20 21 22 23 24 25 23 25 42 36 29 42 44 45 46 32 33 34 35 36 37 38 39 48 42 41 42 44 40 41 42 48
4 6 5 6 7 9 5 5 9 8 6 7 8 5 9 11 12 6 7 9 12 7 12 7 9 7 12 7 9 12 7 12 7 9
4 17 37 18 14 39 15 16 5 18 19 20 21 22 23 20 23 24 17 19 20 23 22 23 24 17 19 20 23 22 23 24 5 19 20 23 22 23 24 17 19 20 23 22 23 24 17 19 20 23 22 23 24 5 19 20 23 22 23 24 17 19 20 23 22 23 24 5 19 20 23 22 23 24 17 19 20 23 22 23
4 5 8 8 9 10 10 10 5 8 10 10 5 8 10 10 5 8 10 10 5 8 10 10 5 8 10 10 5 8 10 10 5 8 10 10 5 8 10 10 5 8 10 10 5 8 10 10 5 8 10 10 5 8 10 10 5 8 10 10 5 8 10 10 5 8 10 10 5 8 10 10 5 8 10 10 5 8 10 10
4 8 7 10 9 8 11 12 14 11 13 23 13 18 19 20 17 7 10 9 22 23 24 25 26 9 22 9 22 23 25 25 26 9
4 31 9 35 6 10 13 12 13 12 13 13 12 18 32 33 18 21 22 23 32 25 36 27 28 33 38 33 22 23 24 25 36 38 40
4 5 15 14 13 5 17 8 9 10 11 7 22 7 22 28 19 18 19 23 27 21 22 21 27 28 29 19 18 27 21 13 16 17 21 27 7 22 27 28 19 18
4 21 6 9 14 8 14 17 15 11 18 15 12 11 18 12 18 12 19 19 19 19 18 12 14 17 15 11 18 12 18 12 19 19 19 19 18 15 14 17 15 11 18 12 18 12 19 19 19 19 18 12 14 17 15 11 18 12 18 12 19 19 19 19 18 12 14 17 15 11 18 12 18 12 19 19 19 19 18 15
4 7 8 9 12 14 15 11 14 22 11 13 13 13 7 22 23 7 8 9 12 14 11 15 11 14 22 13 13 13 7 23 11 9 12 14 22 13 13 13 11 17 23 7 8 9 12 14 22 11 15 13 13 13 11 17 23 7 8 9 12 14 22 11 14 23 13 13 13 21 7 22 7 8 9 12 14 15 11 14
4 32 38 6 31 11 14 10 13 12 15 19 18 19 18 17 16 15 28 24 26 22 29 26 22 29 26 37 38 35 32 30 23 28 22 26 32 40
4 36 21 10 27 10 7 7 10 7 7 7 7 8 7 7 7 8 7 7 7 8 7 7 7 8 7 7 7 8 7 7 7 8 7 7 7 8 7 7 7 23 7 7 7 8 7 7 7 8 7 7 7 8 7 7 7 8 7 7 7 10 7 7 7 8 7 7 7 8 7 7 7 8 7 7 7 10 7 7
4 6 23 8 7 8 12 13 14 15 16 17 11 16 17 15 19 19 13 15 14 15 16 17 16 17 18 19 19 13 12 13 14 15 16 17 16 17 18 19 19 13 12 13 14 15 16 17 16 17 18 19 19 13 12 13 14 15 16 17 16 17 18 19 19 13 12 13 14 15 16 17 16 17 18 19 19 13 12 13
4 5 9 29 11 12 13 14 17 16 18 19 20 22 21 23 23 20 21 22 23 20 21 22 23 20 21 22 23 20 21 22 23 20 21 22 23 20 21 22 23 20 21 22 23 20 21 22 23 20 21 22 23 20 21 22 23 20 21 22 23 20 21 22 23 20 21 22 23 20 21 22 23 20 21 22 23 20 21 23
4 16 9 14 9 14 12 8 6 16 9 16 12 8 6 14 9 14 12 8 6 16 14 12 8 6 14 16 12 8 14 14 12 8 16 16 12 8 16 16 12 8 16 16 12 8 16 16 12 8 16 16 12 8 16 16 12 8 16 16 12 8 14 16 12 8 14 14 12 8 16 16 12 8 16 16 12 8 16 16
4 27 30 27 31 29 30 7 24 24 27 31 26 31 7 31 26 31 27 31 24 7 31 29 31 7 19 19 27 31 26 31 7 31 24 7 31 29 31 7 24 19 27 31 26 31 7 31 24 7 31 29 31 7 24 24 27 31 26 31 7 31 24 7 31 29 31 7 24 24 27 31 26 31 7 31 24 7 31 29
4 5 21 5 8 17 18 19 20 21 22 25 25 26 27 31 14 30 31 14 30 28 14 30 12 21 10 30 31 14 30 5 21 10
4 9 6 7 19 10 13 12 12 9 15 16 17 18 8 20 20 20 19 14 20 20 15 16 17 20 20 20 8 9 20 20 15 16
4 10 7 8 9 6 8 35 6 8 9 10 12 11 13 15 14 16 17 18 19 22 21 24 24 25 26 27 28 29 35 30 31 32 33 36 37
4 8 7 13 9 6 25 16 17 17 18 19 20 21 22 19 20 21 23 24 22 23 24 25 27 29 28 12 26 28 29 23 28 26
4 29 29 6 7 9 22 10 12 13 11 14 15 16 17 14 15 16 17 22 29 29 29 29 29 29 25 26 22 23 26 7 26 19 27 24
4 20 13 9 48 64 13 27 28 30 32 29 33 32 34 39 38 40 41 28 39 32 34 38 40 41 42 39 74 50 69 69 77 68 53 58 50 69 53 77 68 50 69 74 67 73 52 77 68 50 69 74 67 73 52 77 68 64 74 67 73
4 17 17 22 21 21 7 22 21 21 20 21 21 20 21 7 22 21 21 22 21 21 22 21 21 22 21 21 22 21 21 20 21 21
4 5 9 7 5 9 7 10 10 11 10 12 13 12 13 14 11 12 13 12 13 14 11 12 13 12 13 14 11 12 13 12 13 14 11 12 13 12 13 14 11 12 13 12 13 14 11 12 13 12 13 14 11 12 13 12 13 14 11 12 13 12 13 14 11 12 13 12 13 14 11 12 13 12 13 14 11 12 13 12
4 11 18 45 32 39 36 37 33 36 37 38 34 40 42 42 28 56 16 8 56 47 56 47 56 47 56 14 56 47 56 47 56 14
4 32 13 44 23 17 18 19 20 25 21 16 22 24 24 30 36 36 37 46 45 47 48 11 50 51 30 29 44 48 11 50 51 15
4 11 6 8 8 9 9 11 11 14 15 17 18 16 13 12 19 20 21 6 8 8 9 9 9 9 20 21 12 20 21 8 8 9
4 5 17 7 8 9 6 12 13 12 14 15 19 8 18 17 6 17 18 6 17 6 17 6 17 18 6 17 6 17 18 6 17 6
4 55 30 41 42 43 44 29 43 55 54 47 57 7 51 55 54 49 7 51 67 62 49 7 51 67 73 75 70 73 75 70 73 75
4 9 11 12 13 10 15 16 17 18 19 20 22 23 23 25 26 27 28 29 31 32 33 34 38 37 38 8 8 37 38 8 8 37 38
4 5 5 5 5 5 5 5 5 5 5 5 5 5 5 5 5 5 5 5 5 5 7 7 7 7 7 10 10 11 11 12 5 5
4 6 32 35 36 41 27 81 29 30 32 16 17 18 19 19 25 33 21 22 24 23 33 25 35 36 21 23 24 25 33 49 35 36 21 23 24 25 33 49 35 36 21 23 24 25 33 49 35 36 21 23 24 25 33 49 35 36 21 23 24 25 33 49 35 36 21 23 24 25 33 49 35 36 21 23 24 25 33 49
4 7 16 13 15 14 31 32 6 33 24 28 33 24 7 33 32 6 33 24 7 33 28 28 33 32 6 33 24 33 28 7 33 32
4 23 10 16 8 9 12 15 11 14 9 10 16 22 24 23 21 22 24 16 20 20 20 20 24 21 22 1 4 23 24 20 20 24
4 5 6 19 8 20 10 11 12 13 15 16 17 26 15 16 17 27 28 21 22 23 24 25 8 25 10 11 12 13 15 16 17 26 15 16 17 27 28 21 22 23 24 9 5 9 10 11 12 13 15 16 17 26 15 16 17 27 28 21 22 23 24 20 8 20 10 11 12 13 15 16 17 26 15 16 17 27 28 21
4 10 8 6 5 9 12 13 14 15 18 12 11 13 14 15 18 15 16 17 16 17 18 5 9 13 14 15 18 12 11 13 14 15 16 17 18
4 6 6 14 8 11 17 20 18 19 22 23 21 20 22 23 22 23 21 20 22 23 22 21 20 23 22 23 22 21 20 22 23 22 23 21 20 22 23 22 23 21 20 22 23 22 23 21 20 22 23 22 23 21 20 22 23 22 23 21 20 22 23 22 23 21 20 22 23 22 23 21 20 22 23 22 23 21 20 22
4 37 17 39 8 11 12 22 14 24 35 17 11 22 14 24 18 17 20 12 22 23 24 35 17 11 22 14 24 33 17 39 20 12 22 23 24 35 17 11 22 14 24 33 17 39 20 12 22 23 24 35 17 20 22 23 24 18 17 39 11 12 22 14 24 35 17 11 22 14 24 33 17 39 20 12 22 23 24 35
4 5 14 5 9 8 9 10 11 12 14 17 18 19 20 20 10 8 11 14 17 18 19 20 16 19 17 18 19 20 20 14 17 18 19 20
4 14 92 69 100 40 80 46 46 47 49 48 51 41 63 63 42 78 83 37 37 17 58 82 36 76 63 78 83 82 78 83 51 54 37 93 37 76 79 78 76 60
4 17 11 11 7 8 7 9 10 11 12 16 18 16 17 11 17 16 15 17 16 17 11 11 17 16 15 17 16 17 11 11 17 16
4 5 33 25 32 33 32 50 51 42 63 54 61 55 63 43 73 61 33 46 62 38 61 55 41 73 61 53 33 46 54 61 41 73 42 56 46 73 61 74 73 61 56 73 54 61 56 33 46 73 61 55 63 54 61 55 63 43 73 61 33 46 62 54 61 55 63 73 61 53 33 46 38 61 63 73 42 74 46 73
4 8 27 8 9 27 12 11 14 15 16 18 20 19 21 22 21 10 10 16 9 10 12 11 14 10 16 9 18 20 19 21 22 27 16 9 27 23 12 14 27 16 18 20 24 21 22 10 8 9 10 12 11 14 27 16 9 18 20 19 21 22 10 16 9 10 23 12 14 27 16 18 20 24 21 22 27 8 9 27
4 9 9 10 11 12 8 15 14 17 18 15 8 21 21 19 21 8 23 24 25 26 27 28 29 30 35 22 36 37 38 39 43 35 25 36 25 38 25 43
4 23 7 22 23 10 24 14 15 6 17 13 14 15 16 17 13 14 15 16 17 13 14 15 23 17 13 14 15 6 17 13 14 15 16 17 13 21 20 21 8 6 10 24 11 12 13 14 15 16 17 13 21 20 21 22 6 10 24 11
4 8 10 31 10 13 12 15 18 17 19 23 22 23 24 25 27 27 30 29 33 5 31 32 30 16 5 31 32 30 16 5 31 32
4 31 25 52 36 42 41 40 45 46 43 44 8 51 49 8 53 54 46 52 53 54 54 46 52 53 54 54 46 52 53 54 54 46
4 10 11 14 15 16 22 23 24 27 21 22 23 24 28 25 27 9 30 42 30 32 37 23 24 28 25 27 9 30 33 30 32 24
4 9 20 7 9 10 9 20 21 9 20 7 9 20 9 20 7 9 20 9 20 7 9 20 9 20 7 9 20 9 20 7 9 20 9 20 7 9 20 9 20 7 9 20 9 20 7 9 20 9 20 7 9 20 9 20 7 9 20 9 20 7 9 20 9 20 7 9 20 9 20 7 9 20 9 20 7 9 20 9
4 15 7 8 9 10 11 12 13 14 8 16 16 12 13 14 15 16 12 20 19 9 10 6 10 11 12 20 19 9 10 6 10 11 12 20 19 9 10 6
4 26 11 26 13 10 9 15 14 15 17 18 19 21 20 21 17 21 11 19 26 26 26 26 26 26 26 26 11 28 36 30 7 33
4 7 8 9 10 11 12 15 18 21 15 18 21 20 18 18 18 18 18 18 20 15 18 12 20 15 15 18 21 20 18 18 18 21
4 14 8 9 12 11 15 13 14 17 18 19 20 21 22 9 8 9 12 11 15 13 14 17 18 19 20 21 22 9 19 20 22 18 24 19 20 22 18 24 19 20 22 18 24 19 20 22 18 8 9 12 11 15 13 14 17 18 19 20 21 22 9 19 20 22 18 24 19 20 22 18 24 19 20 22 18 24 19 20
4 6 11 8 26 18 19 11 21 13 25 15 27 28 29 30 31 32 34 35 34 30 31 6 29 30 31 34 35 30 31 34 39 42 44 51 44 48 31
4 18 6 7 6 9 10 11 12 13 14 15 16 17 18 15 16 17 18 15 16 17 18 15 16 17 18 15 16 17 18 15 16 17 18 15 16 17 18 15 16 17 18 15 16 17 18 15 16 17 18 15 16 17 18 15 16 17 18 15 16 17 18 15 16 17 18 15 16 17 18 15 16 17 18 15 16 17 18 15
4 6 9 10 21 12 15 16 19 12 21 19 12 15 16 16 19 17 17 26 27 28 29 30 31 29 27 28 29 27 28 29 30 31
4 14 20 20 19 20 20 20 14 15 15 15 18 19 20 19 20 20 14 15 15 18 19 20 19 20 14 15 15 18 19 20 19 20
4 26 7 8 11 13 14 12 13 15 18 17 18 19 16 16 17 18 17 19 16 16 18 17 18 19 16 16 17 18 17 19 16 16 18 17 18 19 16 16 17 18 17 19 16 16 18 17 18 19 16 16 18 17 18 19 16 16 17 18 17 19 16 16 18 17 18 19 16 16 17 18 17 19 16 16 18 17 18 19
4 10 41 45 29 9 48 51 23 54 58 32 64 65 35 65 33 19 50 34 66 75 91 59 13 90 75 91 74 90 13 74 74 90 75 91 91 90 75 91 91 90 75 91 91 90 75 74 91 90 75 91 91 90 75 91 91 90 75 91 91 90 75 91 91 90 75 91 74 90 75 74 91 90 75 74 74 90 75 91
4 6 8 9 10 13 34 10 9 10 21 20 22 23 20 28 27 22 23 27 28 27 28 23 30 30 16 16 34 9 9 11 11 34
4 14 7 8 9 21 22 23 24 25 26 28 24 28 32 33 34 40 41 43 44 40 43 44 40 13 40 8 40 43 44 40 11 40
4 6 7 8 9 10 12 13 14 13 14 16 17 6 19 6 19 21 22 23 25 25 23 25 12 14 13 14 16 17 6 19 6 19 21 22 23 25
4 21 22 23 10 11 13 10 12 14 22 16 18 6 21 23 19 19 18 6 21 22 23 19 18 6 9 23 19 18 19 6 9 23
4 7 7 20 12 12 17 13 14 15 16 17 13 15 14 15 16 17 13 15 14 15 16 17 13 15 14 15 16 17 13 15 14 15 16 17 13 15 14 15 16 17 13 15 14 15 16 17 13 15 14 15 16 17 13 15 14 15 16 17 13 15 14 15 16 17 13 15 14 15 16 17 13 15 14 15 16 17 13 15
4 38 6 32 21 7 8 28 11 13 15 16 18 17 20 19 19 32 32 21 24 26 21 21 37 23 8 38 39 25 21 36 39 38
4 16 20 30 25 29 27 33 38 39 32 38 39 27 42 43 40 41 42 43 45 16 50 44 49 43 45 16 23 50 46 20 44 20
4 8 6 10 5 18 11 9 15 17 18 21 21 21 24 22 23 24 22 18 18 7 18 22 23 24 22 24 18 22 23 24 22 18
4 12 10 13 14 15 21 22 23 26 20 21 22 23 24 26 8 20 21 22 23 24 39 40 23 24 26 31 37 29 42 40 23 32 33 31
4 12 9 10 8 13 7 5 16 14 15 18 17 18 16 22 21 20 24 23 6 24 19 23 13 24 19 24 22 23 13 24 10 24
4 9 27 26 14 10 11 7 26 14 10 11 25 31 14 15 16 17 18 17 18 9 21 11 13 26 14 13 8 14 11 13 26 14 15 16 17 18 17 18 9 21 11 13 26 14 13 29 14 11 13 26 14 15 16 17 18 17 18 9 21 11 13 26 14 13 29 14 11 13 26 14 15 16 17 18 17 18 6 21
4 7 7 8 9 10 11 12 15 36 58 64 49 43 37 22 53 51 6 35 50 37 6 53 51 6 42 57 57 37 55 53 61 62 63
4 25 7 45 16 17 27 32 25 26 29 30 31 34 35 36 37 38 32 25 17 45 16 17 45 25 27 32 25 28 26 29 30 31 34 35 36 37 38 32 25 17 45 10 17 45 25 27 32 25 28 26 29 30 31 34 35 36 37 38 32 25 17 45 10 17 45 25 27 32 25 28 26 29 30 31 34 35 36 37
4 40 6 20 21 22 23 24 25 26 28 27 30 23 26 27 40 34 35 36 22 9 6 36 9 38 6 36 30 22 6 30 9 12
4 23 7 23 7 11 24 11 18 17 13 15 18 17 13 18 17 20 19 10 22 23 26 27 27 21 8 22 23 27 23 27 27 8
4 9 7 8 20 10 10 11 13 14 35 15 17 16 19 18 19 18 17 19 18 19 15 17 16 19 18 19 17 18 19 15 17 16 19 18 19 17 18 19 15 17 16 19 18 19 17 18 19 15 17 16 19 18 19 17 18 19 15 17 16 19 18 19 17 18 19 15 17 16 19 18 19 18 17 19 15 17 19 18
4 12 27 8 17 14 15 16 15 16 19 20 21 24 10 29 7 12 8 17 17 29 24 10 29 7 12 29 12 29 17 29 17 29
4 12 36 13 31 19 34 15 23 35 22 18 37 35 36 18 37 16 19 37 35 17 37 37 54 54 54 53 53 53 53 53 53 54
4 5 13 17 14 7 16 19 20 6 24 23 26 22 28 25 29 32 31 33 34 30 32 33 31 34 32 33 31 34 32 33 31 34 30 32 33 31 34 32 33 31 34 30 32 33 31 34 32 33 31 34 30 32 33 31 34 32 33 31 34 30 32 33 31 34 32 33 31 34 30 32 33 31 34 32 33 31 34 30
4 6 6 8 26 10 55 57 6 15 34 18 16 17 19 33 21 30 38 22 21 22 46 41 32 32 22 21 30 38 32 22 21 22 46 37 57 32 32 22 22 53 57 60 62 63 62 32
4 6 7 10 9 7 15 11 12 13 14 15 16 19 7 20 15 10 6 7 15 7 10 7 20 15 8 7 20 15 8 7 20 15
4 15 6 29 12 13 14 19 20 17 18 19 20 21 22 23 24 26 24 7 30 32 32 32 32 30 7 33 7 11 27 5 32 32
4 34 48 29 22 16 22 16 22 38 20 28 19 34 19 48 38 37 38 14 14 32 19 29 22 16 22 13 21 48 19 8 19 8
4 14 9 10 9 13 14 8 28 14 9 17 14 8 28 14 9 9 10 8 28 14 8 28 14 9 17 14 8 28 14 9 9 10 8 28 14 9 17 14 8 28 14 9 9 10 8 28 14 9 17 14 8 28 14 9 9 10 8 28 14 9 17 14 8 28 14 9 9 10 8 28 14 9 17 14 8 28 14 9
4 14 16 9 14 25 23 24 22 23 24 14 25 22 23 24 14 22 23 24 14 25 22 23 17 22 14 23 22 24 14 25 24 14 22 23 17 22 14 25 24 14 23 22 25 24 14 22 23 17 22 14 23 22 24 14 25 24 14 22 23 17 22 14 25 24 14 23 22 25 24 14 22 23 17 22 14 23 22 24
4 52 23 24 47 30 27 28 21 22 29 23 36 34 35 5 37 9 34 35 36 21 22 29 34 36 35 15 34 21 22 23 27 36 34 35 21 22 29 34 36 35 15 37 9 34 35 21 22 29 34 36 35 5 34 21 22 23 27 36 34 35 21 22 29 34 36 35 15 37 9 34 35 21 22 29 34 36 35 5
4 17 18 17 14 7 17 14 18 17 14 18 17 18 17 14 18 17 14 18 17 7 17 14 18 17 14 18 17 7 17 14 18 17 14 18 17 18 17 14 18 17
4 8 8 9 10 11 12 12 25 19 18 19 22 21 24 25 27 30 16 32 33 34 36 34 14 14 38 33 34 14 14 38 36 34 33
4 11 10 9 9 15 13 13 14 18 19 20 19 15 13 18 22 22 20 19 15 13 14 18 19 20 22 22 7 11 11 11 22 7
4 6 5 6 11 19 20 21 22 31 17 11 19 20 21 22 31 24 25 26 27 28 29 30 32 33 34 35 36 37 39 41 40 39 8
4 7 8 12 15 19 17 16 20 18 28 29 27 28 29 26 21 33 33 32 40 41 21 35 42 40 41 40 42 40 41 40 41 21
4 21 16 21 22 8 7 11 9 10 10 15 15 6 16 18 18 18 18 21 16 21 22 8 9 11 10 15 15 6 16 18 18 18 21
4 8 9 23 5 6 7 5 14 16 17 18 22 15 15 14 16 17 18 22 18 20 21 24 22 24 6 24 6 24 22 6 24 10
4 11 21 20 18 19 21 20 22 31 24 31 10 29 31 10 29 31 10 13 15 11 11 15 28 26 15 29 30 17 31 10 29 31
4 16 17 11 19 11 19 45 29 9 17 11 19 45 20 21 22 23 24 21 22 23 24 21 22 23 24 21 22 37 51 49 34 36 45 44
4 9 7 8 6 10 11 13 14 15 16 17 18 22 23 19 20 19 21 11 25 26 27 28 29 30 31 32 33 34 36 37 35 36 37
4 6 14 14 6 10 8 9 8 10 9 8 10 8 12 13 6 12 13 6 14 6 14 6 10 9 8 10 9 8 10 8 12 13 6
4 6 17 9 5 9 10 9 5 9 10 9 5 9 5 20 14 15 17 20 20 20 20 20 20 20 20 20 20 20 20 20 20 20
4 5 6 26 46 39 26 60 19 43 49 50 51 52 53 54 55 52 53 54 71 78 80 81 77 79 79 79 53 59 83 79 81 82 79 78 79
4 5 6 7 5 9 11 10 11 12 13 14 10 15 16 17 18 19 20 19 20 21 22 23 24 25 26 27 28 29 31 32 33 34
4 6 7 22 6 10 11 12 13 14 15 16 17 18 17 18 14 15 16 17 18 17 18 14 15 16 17 18 17 18 14 15 16 17 18 17 18 14 15 16 17 18 17 18 14 15 16 17 18 17 18 14 15 16 17 18 17 18 14 15 16 17 18 17 18 14 15 16 17 18 17 18 14 15 16 17 18 17 18 14
4 11 14 16 17 17 21 22 23 24 13 26 26 5 32 28 35 14 35 6 30 28 29 9 11 12 13 14 29 6 8 31 28 35 9 11 12 13 14 29 6 8
4 9 22 22 9 23 23 10 16 14 13 15 16 17 14 15 16 17 31 21 27 31 27 31 27 27 21 27 27 31 7 7 22 9
4 13 7 7 11 9 10 12 13 12 13 9 11 10 12 13 9 12 13 5 7 7 11 9 12 13 5 7 7 11 9 12 13 5 7 7 11 9 12 13 5 7 7 11 9 12 13 5 7 7 11 9 12 13 5 7 7 11 9 12 13 5 7 7 11 9 12 13 5 7 7 11 9 12 13 5 7 7 11 9
4 6 7 22 6 12 13 13 17 16 19 18 19 6 13 15 16 17 19 18 34 25 25 34 25 25 53 47 10 53 47 55 59 55 45 53
4 5 88 13 22 21 21 27 27 23 74 26 27 27 33 38 33 26 27 27 10 44 74 26 52 33 32 33 26 27 27 10 44 74 26 52 33 32 33 26 27 27 10 44 74 26 52 33 32 33 26 27 27 17 44 74 26 52 33 38 33 26 27 27 10 44 74 26 52 33 38 33 26 27 27 17 44 74 26 52
4 9 5 6 28 5 15 13 12 14 15 19 20 23 24 17 18 19 22 23 24 17 26 17 21 22 23 24 25 24 17 18 19 20 22 23 24 25 24 17 18 19 20 22 23 24 17 26 17 21 22 23 24 25 24 17 18 19 20 22 23 24 25 24 17 18 19 20 22 23 24 17 26 17 21 22 23 24 25 24
4 10 7 17 15 6 28 17 27 29 25 30 50 26 32 31 33 33 52 21 50 32 31 33 33 41 21 50 32 31 33 33 17 21 50 32 31 33 33 17 21 50 32 31 33 33 17 21 50 32 31 33 33 17 21 50 32 31 33 33 17 21 50 32 31 33 33 41 21 50 32 31 33 33 17 58 50 32 31 33
4 9 7 8 6 10 16 11 14 15 12 13 14 15 18 22 23 19 20 19 21 16 25 26 45 32 39 40 29 30 31 32 43 44 35 36 45 38
4 6 22 6 22 10 11 12 14 15 16 19 18 17 20 11 20 19 18 17 20 19 20 11 23 23 31 26 27 29 30 8 8 29
4 8 21 6 9 10 11 12 13 15 24 11 16 17 16 17 22 23 24 25 26 27 28 23 24 25 26 27 28 23 24 25 26 27
4 10 5 11 13 14 15 16 18 17 19 10 18 17 16 15 18 18 17 19 10 13 30 27 32 21 26 27 32 33 9 9 31 32 39 40 41 42
4 6 13 14 10 11 9 13 14 12 16 16 11 9 12 10 13 14 13 14 15 16 16 11 9 12 10 13 14 13 14 15 16 16 11 9 12 10 13 14 13 14 15 16 16 11 9 12 10 13 14 13 14 15 16 16 11 9 12 10 13 14 13 14 15 16 16 11 9 12 10 13 14 13 14 15 16 16 11 9
4 43 6 22 24 25 26 72 29 31 67 34 40 36 42 43 47 46 53 53 46 46 75 64 76 46 75 66 74 69 75 73 65 68 70
4 5 6 7 8 5 10 11 12 13 10 11 12 13 17 18 15 16 17 18 19 20 21 22 23 24 25 26 26 26 28 29 27 29
4 6 7 18 11 9 12 9 10 14 6 10 14 16 20 20 19 7 6 17 18 19 16 20 19 16 20 17 6 19 16 20 19 17
4 11 18 33 32 51 18 36 22 20 56 35 37 56 35 11 11 18 52 18 54 22 20 56 35 37 56 35 11 11 18 52 18 36 39 20 56 57 37 56 35 11 11 18 52 18 54 39 20 56 57 37 56 35 11 11 18 52 18 54 39 20 56 57 37 56 35 11 11 18 52 18 54 39 20 56 57 37 56 57
4 103 30 94 31 34 125 18 124 58 10 20 21 96 39 42 93 25 110 110 125 126 94 24 102 116 93 90 74 99 7 130 92 33 40 116 9
4 5 6 32 12 7 8 20 19 11 15 23 16 18 14 23 32 18 16 10 14 23 17 18 16 18 14 23 32 18 16 19 14 23 24 18 16 18 14 23 32 18 16 10 14 23 24 18 16 18 14 23 32 18 16 10 14 23 24 18 16 18 14 23 32 18 16 10 14 23 17 18 16 18 14 23 32 18 16 10
