4 7 23 7 10 11 10 14 15 12 15 16 18 19 20 21 7 16 23 24 24 23 24 23 24 23 24 23 24 23 24 23 24 23
4 10 7 12 12 8 16 16 17 18 21 21 17 18 21 24 27 27 27 27 14 19 14 19 14 19 14 8 14 8 14 19 14 19
4 26 28 28 29 29 29 29 29 29 29 29 29 29 29 29 29 29 29 29 29 29 29 29 29 29 29 29 29 29 29 29 29 29 29 29 29 29 29 29 29 29 29 29 29 29 29 29 29 29 29 29 29 29 29 29 29 29 29 29 29 29 29 29 29 29 29 29 29 29 29 29 29 29 29 29 29 29 29 29
4 6 16 14 12 16 18 19 18 19 20 22 23 25 24 25 20 10 31 30 10 34 33 34 31 30 10 33 34 31 32 10 33 34
4 5 20 5 6 7 7 9 12 10 14 11 13 14 17 15 17 22 22 20 15 17 22 20 26 27 28 29 29 30 30 29 30 21
4 6 8 9 10 11 30 13 14 10 20 16 17 18 22 23 21 22 24 25 30 38 38 31 31 38 37 36 34 34 17 17 6 12 31 38
4 7 6 7 7 7 7 7 7 7 7 7 7 7 7 7 7 7 7 7 7 7 7 7 7 7 7 7 7 7 7 7 7 7 7 7 7 7 7 7 7 7 7 7 7 7 7 7 7 7 7 7 7 7 7 7 7 7 7 7 7 7 7 7 7 7 7 7 7 7 7 7 7 7 7 7 7 7 7 7
4 18 6 24 22 23 20 22 19 19 19 19 18 24 22 23 20 19 19 19 7 32 35 35 9 45 17 47 40 40 17 35 35 9 38 46 47 40
4 11 7 11 10 11 10 7 14 15 16 18 19 25 24 22 23 27 28 29 30 31 32 33 34 36 35 36 12 12 30 31 32 33 34 36 35 36
4 22 6 7 7 22 7 22 7 22 7 22 7 22 7 22 7 22 7 22 7 22 7 22 7 22 7 22 7 22 7 22 7 22 7 22 7 22 7 22 7 22 7 22 7 22 7 22 7 22 7 22 7 22 7 22 7 22 7 22 7 22 7 22 7 22 7 22 7 22 7 22 7 22 7 22 7 22 7 9
4 59 20 29 29 38 38 38 38 11 20 20 29 29 38 38 38 38 11 20 29 38 38 38 11 20 29 38 38 38 11 20 29 38 38 38 11 20 29 38 38 38 11 20 29 38 38 38 11 20 29 38 38 38 11 20 29 38 38 38 11 20 29 38 38 38 11 20 29 38 38 38 11 20 29 38 38 38 11 20
4 9 8 10 9 10 9 8 10 9 10 9 8 10 9 10 9 8 10 9 10 9 8 10 9 10 9 8 10 9 10 9 8 10 9 10 9 8 10 9 10 9 8 10 9 10 9 8 10 9 10 9 8 10 9 10 9 8 10 9 10 9 8 10 9 10 9 8 10 9 10 9 8 10 9 10 9 8 10 9
4 9 11 8 7 12 9 8 8 9 13 8 5 17 21 7 12 5 8 14 20 8 9 13 8 5 17 21 8 9 13 8 9 17 8 9 13 8 5 17 21 8 9 13 8 9 17 8 9 13 8 5 17 21 8 9 13 8 5 17 8 9 13 8 5 17 21 8 9 13 8 9 17 8 9 13 8 5 17 28
4 6 7 8 11 6 22 23 24 19 26 25 27 26 25 26 27 20 26 25 26 27 31 30 31 34 9 7 36 13 32 12 14 7 31
4 9 7 8 9 10 11 12 13 14 15 16 17 18 19 20 18 17 22 23 24 25 26 27 28 29 30 31 32 33 34 35 24 25 34 35
4 5 28 17 25 23 24 23 24 39 32 42 44 40 48 66 69 71 77 87 88 89 90 79 77 85 78 91 95 93 87 75 89 75 79 77 85 78
4 6 9 9 14 16 19 19 15 20 18 17 18 25 23 24 17 18 25 23 24 17 18 25 23 24 17 18 25 23 24 17 18 25 23 24 17 18 25 23 24 17 18 25 23 24 17 18 25 23 24 17 18 25 23 24 17 18 25 23 24 17 18 25 23 24 17 18 25 23 24 17 18 25 23 24 17 18 25 23
4 7 6 12 5 5 5 8 7 9 8 7 11 7 9 12 15 12 7 9 7 9 12 7 9 12 7 9 12 7 12 7 9 12
4 5 17 38 14 15 16 5 18 19 20 23 22 23 20 23 24 5 26 27 30 31 34 39 24 30 39 24 30 39 15 16 17 39 7 39
4 5 8 8 10 10 10 10 10 10 10 10 10 10 10 10 10 10 10 10 10 10 10 10 10 10 10 10 10 10 10 10 10 10 10 10 10 10 10 10 10 10 10 10 10 10 10 10 10 10 10 10 10 10 10 10 10 10 10 10 10 10 10 10 10 10 10 10 10 10 10 10 10 10 10 10 10 10 10 10
4 6 7 10 9 6 11 12 13 13 14 23 11 13 18 19 20 20 22 23 25 26 9 22 9 22 7 22 26 9 22 23 25 9
4 8 9 18 6 10 13 13 12 13 13 12 10 13 13 12 13 13 12 13 10 13 13 12 13 13 19 19 24 21 22 23 24 34 36 27 28 27 28 38 33 38 41 32 33 26
4 16 15 16 17 9 8 8 9 10 11 22 7 10 11 28 29 19 18 18 19 29 18 18 21 22 27 28 29 19 18 18 19 29
4 21 6 9 8 14 17 15 11 17 15 11 18 12 11 18 12 19 19 19 18 12 11 18 12 19 19 19 18 12 11 18 12 19 19 19 18 12 11 18 12 19 19 19 18 12 11 18 12 19 19 19 18 12 11 18 12 19 19 19 18 12 11 18 12 19 19 19 18 12 11 18 12 19 19 19 18 12 11 18
4 7 8 9 12 14 15 11 14 11 13 13 13 6 17 22 23 19 19 23 6 17 6 17 6 17 19 19 23 19 19 23 6 17
4 32 6 31 11 13 10 9 12 15 19 18 19 18 17 16 22 22 26 29 22 26 29 33 38 35 38 30 23 28 22 26 29 33
4 32 23 7 7 10 10 10 10 10 10 10 27 18 19 19 20 21 19 19 18 19 20 21 31 31 33 36 31 31 31 31 31 24
4 6 23 8 7 8 12 11 11 14 15 16 17 16 17 18 19 19 19 19 26 25 26 7 26 7 26 7 26 7 26 7 26 7
4 5 9 29 11 12 13 16 17 18 34 20 21 22 23 23 21 22 23 20 21 22 23 14 13 29 20 21 22 23 21 22 23 20 21 22 23 14 13 29 20 21 22 23 21 22 23 20 21 22 23 14 13 29 20 21 22 23 21 22 23 20 21 22 23 14 13 29 20 21 22 23 21 22 23 20 21 22 23 14
4 21 9 21 21 12 8 16 14 12 16 12 14 5 8 16 14 12 14 5 8 14 9 6 12 14 5 8 16 14 12 16 5 8 14 9 6 12 16 5 8 16 14 12 16 5 8 14 9 6 12 16 5 8 16 14 12 16 5 8 14 9 6 12 16 5 8 16 14 12 16 5 8 14 9 6 12 16 5 8
4 8 27 30 27 25 8 17 18 16 18 19 19 8 5 30 7 30 25 26 31 29 31 10 25 31 26 31 24 19 10 25 31 26
4 7 6 7 8 17 19 18 19 20 21 22 24 26 25 26 25 26 29 31 21 10 27 31 14 21 27 31 14 30 31 14 21 11
4 6 6 7 14 10 12 13 12 13 9 15 16 17 18 19 9 20 9 20 8 9 20 19 9 20 16 17 18 8 9 20 9 20
4 10 7 8 9 35 10 8 9 35 10 8 9 35 10 8 9 35 10 8 9 35 10 8 9 35 10 8 9 35 10 8 9 35 10 8 9 35 10 8 9 35 10 8 9 35 10 8 9 35 10 8 9 35 10 8 9 35 10 8 9 35 10 8 9 35 10 8 9 35 10 8 9 35 10 8 9 35 10 8
4 8 10 28 12 13 9 10 16 17 17 18 19 20 21 22 19 21 22 19 20 21 30 24 22 19 20 21 30 24 22 19 20 21 23 24 22 19 20 21 30 24 22 19 20 21 23 24 22 19 20 21 23 24 22 19 20 21 30 24 22 19 20 21 23 24 22 19 20 21 23 24 22 19 20 21 23 24 22 19
4 29 29 6 19 9 10 11 12 13 14 15 16 17 14 15 16 17 29 29 29 25 26 19 27 24 26 19 27 24 26 19 27 24
4 20 13 17 13 30 27 28 29 32 33 32 37 28 38 40 41 39 42 39 40 41 42 39 38 40 41 42 39 34 38 40 41 39 42 42 39 40 41 42 39 38 40 41 42 39 34 38 40 41 39 42 42 39 40 41 42 39 38 40 41 42 39 34 38 40 41 39 42 42 39 40 41 42 39 38 40 41 42 39
4 7 17 17 17 20 7 22 17 22 21 22 17 22 17 22 17 22 17 20 21 22 17 22 17 22 17 20 21 22 17 22 17 22 17 22 21 20 7 22 17 22 17 20 21 22 17 22 17 22 17 20 21 22 17 22 17 22 17 20 21 22 17 22 17 22 17 20 21 22 17 22 17 22 17 20 21 22 17 22
4 24 24 9 7 24 9 11 10 10 12 13 12 13 12 13 12 13 12 13 12 11 10 10 12 13 12 13 12 13 12 13 12 13 12 13 12 13 12 13 12 13 12 13 12 13 12 13 12 13 12 13 12 13 12 13 12 13 12 13 12 13 12 13 12 13 12 13 12 13 12 13 12 13 12 13 12 13 12 13
4 31 26 45 32 39 36 37 33 38 34 40 42 42 28 56 52 9 5 55 49 56 47 56 47 56 47 56 49 56 47 56 52 56
4 37 32 13 23 17 18 19 20 25 21 22 24 24 22 24 38 36 29 35 36 37 44 45 47 50 51 11 51 12 33 44 46 48 49 50 51 51 12
4 11 17 18 16 11 20 21 20 21 6 8 8 8 9 23 21 20 21 20 21 6 8 8 8 9 23 21 20 21 6 8 8 9
4 5 7 17 7 18 12 13 12 14 15 19 8 17 6 17 18 6 17 6 17 18 17 18 17 18 17 6 17 18 18 17 6 17
4 7 55 55 47 7 70 73 75 70 75 70 70 73 75 70 68 70 51 62 49 70 51 54 63 59 67 73 75 70 73 75 70 51
4 9 15 11 10 13 10 11 10 7 16 17 18 19 20 22 22 23 25 26 27 28 31 32 34 38 37 40 8 37 40 8 8 37 40 8
4 5 5 5 5 5 5 5 5 5 5 5 5 5 5 5 5 5 5 5 5 5 5 5 5 5 5 5 5 5 5 5 5 5 5 5 5 5 5 5 5 5 5 5 5 5 5 5 5 5 5 5 5 5 5 5 5 5 5 5 5 5 5 5 5 5 5 5 5 5 5 5 5 5 5 5 5 5 5 5
4 52 15 7 8 26 27 81 48 48 32 16 17 18 20 19 19 22 23 24 25 33 35 8 9 38 38 49 7 38 56 57 58 77 64 77 27 77 78 62 60 55 65 78 62 72 71 68 78 62 72 77 27 77 78 62 60 55 65 78 59 72 71 68 78
4 19 34 28 33 24 28 28 33 24 28 7 33 28 28 7 33 28 28 7 33 28 28 7 33 28 28 7 33 28 28 7 33 28 28 7 33 28 28 7 33 28 28 7 33 28 28 7 33 28 28 7 33 28 28 7 33 28 28 7 33 28 28 7 33 28 28 7 33 28 28 34 33 28 28 7 33 28 28 28
4 20 20 20 10 8 9 12 15 14 11 15 14 9 10 16 8 12 15 14 9 11 15 14 9 10 16 21 22 23 24 20 21 22
4 8 6 7 5 10 11 12 14 15 16 17 15 16 15 17 26 27 28 21 22 23 24 25 8 20 8 9 19 8 9 7 5 20
4 7 8 6 5 9 12 11 13 14 15 18 12 12 11 13 14 15 16 17 17 18 9 6 7 9 6 5 9 14 6 5 9 9
4 6 14 8 6 17 20 18 19 17 20 20 22 23 22 23 21 20 22 23 22 23 21 20 22 23 22 23 21 20 22 23 22 23 21 20 22 23 22 23 21 20 22 23 22 23 21 20 22 23 22 23 21 20 22 23 22 23 21 20 22 23 22 23 21 20 22 23 22 23 21 20 22 23 22 23 21 20 22 23
4 37 17 39 19 20 13 12 13 23 24 24 40 32 17 42 17 20 13 12 23 24 24 40 5 17 42 17 20 13 12 14 24 24 40 5 17 42 17 20 13 12 14 24 24 40 5 17 42 17 11 13 12 14 24 24 40 5 17 42 17 20 13 12 14 24 24 40 5 17 42 17 20 13 12 14 24 24 40 25
4 5 6 5 9 8 9 10 11 10 11 6 14 17 18 19 20 20 14 17 18 19 20 20 14 17 18 19 20 20 14 17 18 19 20
4 68 59 9 56 57 22 40 46 49 46 47 48 47 51 50 41 66 105 82 109 82 78 83 76 82 78 59 9 88 57 69 40 67 63 36 78 83
4 11 18 11 11 8 7 9 10 11 12 16 17 16 15 17 16 17 11 17 16 15 17 11 17 16 15 17 11 17 16 15 17 11
4 13 28 9 30 31 32 50 51 55 68 54 61 60 61 33 46 38 61 52 33 46 67 61 47 61 33 46 38 61 68 33 46 67 61 47 61 33 46 38 61 68 33 46 38 61 47 61 33 46 38 61 68 33 46 38 61 47 61 33 46 38 61 68 33 46 38 61 60 61 33 46 54 61 68 33 46 54 61 60
4 6 7 8 9 10 13 11 12 15 14 18 20 19 21 22 27 16 26 30 31 31 31 16 30 31 10 31 16 30 31 31 16 30
4 5 9 6 11 13 14 16 17 18 15 19 21 21 8 23 28 26 34 29 34 35 36 37 38 39 43 35 25 36 37 38 39 43
4 23 7 22 23 17 13 14 15 16 17 13 21 20 21 14 15 7 22 16 25 7 22 16 25 7 22 9 25 7 22 16 25 7 22 9
4 8 10 29 6 15 13 21 23 22 23 24 25 27 27 30 32 30 32 30 32 32 30 32 32 30 31 32 9 30 33 32 30 32
4 31 25 14 42 40 41 45 46 43 44 51 49 50 51 52 53 54 54 46 52 54 54 30 30 30 46 54 54 15 15 28 28 28
4 10 11 12 10 14 15 16 14 22 23 24 21 22 23 24 25 40 41 24 25 27 36 37 24 29 30 35 36 37 28 24 25 27 32
4 9 10 10 10 9 10 13 10 9 10 13 10 9 10 13 9 10 13 9 10 13 9 19 13 9 10 13 9 10 13 9 19 13 9 19 13 9 19 13 9 19 13 9 19 13 9 19 13 9 19 13 9 10 13 9 10 13 9 19 13 9 19 13 9 19 13 9 19 13 9 19 13 9 19 13 9 19 13 9
4 13 14 15 16 12 13 14 15 16 16 12 20 19 13 14 8 10 10 10 8 10 10 14 15 16 12 20 19 13 14 8 10 10
4 26 11 10 9 15 15 15 14 17 18 19 21 18 21 19 21 11 26 26 26 26 26 36 26 26 26 36 26 26 36 30 7 33
4 7 8 9 10 11 12 15 15 20 18 21 18 21 20 18 18 21 18 18 18 21 20 18 18 18 21 20 18 18 18 18 21 20
4 14 8 12 15 13 14 16 17 19 20 21 22 19 20 22 19 20 22 19 20 22 19 20 22 19 20 22 19 20 22 19 20 22 19 20 22 19 20 22 19 20 22 19 20 22 19 20 22 19 20 22 19 20 22 19 20 22 19 20 22 19 20 22 19 20 22 19 20 22 19 20 22 19 20 22 19 20 22 19
4 20 6 20 24 18 23 9 27 28 29 30 31 34 39 40 42 14 44 31 51 44 48 31 34 39 53 43 42 14 44 31 40 48 51 44 48 31
4 18 6 20 6 9 10 11 12 13 14 15 16 17 18 15 16 17 18 15 16 17 18 15 16 17 18 15 16 17 18 15 16 17 18 15 16 17 18 15 16 17 18 15 16 17 18 15 16 17 18 15 16 17 18 15 16 17 18 15 16 17 18 15 16 17 18 15 16 17 18 15 16 17 18 15 16 17 18 15
4 6 7 11 12 21 19 12 15 13 24 19 21 23 20 24 17 26 26 27 28 29 5 27 28 29 27 5 27 28 29 5 24 31
4 18 19 20 20 20 18 20 20 18 20 20 19 20 20 20 18 20 20 18 20 19 20 20 20 18 20 20 18 20 20 19 20 20
4 26 7 8 11 13 12 13 14 12 15 18 17 19 16 19 16 26 8 25 26 8 26 25 26 8 26 25 26 8 26 25 26 8
4 40 11 45 45 48 21 23 54 54 54 58 62 63 19 50 64 66 65 33 49 50 34 66 65 33 19 50 64 66 65 63 49 50 34 66 65 63 19 50 64 66 65 63 19 50 64 66 65 63 19 50 64 66 65 63 19 50 64 66 65 63 19 50 64 66 65 63 19 50 64 66 65 63 19 50 64 66 65 63
4 6 34 6 13 6 13 8 34 10 13 10 34 10 13 6 13 8 34 10 9 10 21 18 11 22 23 20 28 27 25 24 29 30 30 13 34 9
4 9 36 37 11 6 15 18 40 19 18 11 14 8 19 20 18 22 23 24 25 26 28 32 33 34 19 42 43 44 11 8 43 44
4 6 7 8 12 11 10 9 13 14 13 14 16 17 6 19 6 19 18 19 18 19 21 22 23 25 24 25 19 17 22 23 25 24
4 21 7 7 7 10 11 13 11 12 14 22 23 16 18 21 19 19 6 9 23 19 18 19 19 6 9 23 9 23 19 19 6 9
4 6 21 18 7 7 7 7 10 7 7 7 7 10 7 7 7 7 7 10 7 7 7 7 10 7 7 7 7 7 10 7 7 7 7 10 7 7 7 7 7 10 7 7 7 7 10 7 7 7 7 7 10 7 7 7 7 10 7 7 7 7 7 10 7 7 7 7 10 7 7 7 7 7 10 7 7 7 7 7
4 34 6 8 6 21 11 12 13 14 15 24 16 18 17 20 19 19 26 32 32 26 26 26 21 37 23 8 38 39 30 21 21 36 39
4 23 16 23 30 25 27 29 32 36 38 39 38 39 38 40 41 42 43 43 45 46 43 43 16 50 50 44 46 43 43 43 20 50
4 5 6 10 5 11 15 9 11 17 15 17 18 21 21 21 23 24 22 23 24 22 23 24 22 23 24 22 23 24 22 23 24 22
4 12 10 43 12 13 14 15 21 22 23 20 21 22 23 44 24 26 39 44 45 23 28 29 34 35 36 27 23 24 26 39 8 44 45
4 8 13 10 5 10 11 5 9 14 15 16 18 17 18 17 18 17 18 17 18 22 20 20 24 13 24 23 9 24 7 24 11 11
4 9 30 14 10 11 7 14 15 16 17 18 17 18 17 21 21 11 7 23 24 31 14 26 23 29 9 29 8 14 8 23 13 31
4 7 7 64 48 31 8 10 11 9 8 14 12 15 14 13 7 34 64 31 38 31 64 25 31 8 10 11 9 8 14 12 15 14 13 7 38 64 36 38 39 51 6 35 50 44 29 53 61 62 63 21
4 25 7 45 25 27 26 29 28 31 34 35 28 36 37 38 32 11 16 11 16 7 35 28 29 31 34 35 28 36 37 38 32 11 16 11 16 7 35 28 29 31 34 35 28 36 37 38 32 11 16 11 10 7 35 28 29 31 34 35 28 36 37 38 32 11 16 11 16 11 35 28 29 31 34 35 28 36 37 38
4 40 23 19 20 21 22 23 24 25 26 28 27 30 5 34 35 36 9 13 13 13 39 6 25 26 28 27 30 40 26 27 28 27 30 5 34 35 36 9 13 12
4 23 7 6 7 11 24 13 15 16 17 18 17 18 17 20 19 10 21 22 25 26 27 27 27 8 25 27 24 27 27 21 22 25
4 9 7 8 9 10 10 13 14 13 15 17 16 19 18 19 18 17 19 18 19 18 17 19 18 19 18 17 19 18 19 15 17 19 18 19 18 17 19 18 19 15 17 16 19 18 19 18 17 19 15 17 19 18 19 18 17 19 18 19 15 17 16 19 18 19 18 17 19 15 17 16 19 18 19 18 17 19 18 19
4 12 8 8 27 14 14 16 15 20 19 24 24 29 12 29 8 29 17 29 17 29 8 29 17 29 8 29 17 29 27 29 17 29
4 12 13 12 19 34 37 37 17 21 37 37 37 54 53 53 53 53 53 53 53 53 53 53 53 53 53 53 53 53 53 53 53 53
4 5 8 14 6 26 22 24 25 28 27 32 33 31 34 30 30 32 33 31 34 30 32 33 31 34 30 30 32 33 31 34 30 30 32 33 31 34 30 30 32 33 31 34 30 30 32 33 31 34 30 30 32 33 31 34 30 30 32 33 31 34 30 30 32 33 31 34 30 30 32 33 31 34 30 30 32 33 31 34
4 6 6 8 26 51 55 13 6 15 18 33 17 19 33 21 30 38 22 22 41 46 49 11 13 60 62 63 62 32 62 62 63 32
4 9 15 9 8 9 7 10 6 7 11 12 13 14 15 16 19 20 7 21 21 21 7 15 10 7 10 7 15 7 15 10 7 21
4 14 6 20 12 20 12 20 12 13 20 18 5 12 20 18 12 13 14 19 20 21 22 23 23 22 26 24 26 6 27 31 30 32
4 13 10 10 22 22 22 22 10 34 34 48 29 22 22 22 22 22 16 10 34 34 48 29 22 22 22 22 22 16 10 34 34 48 29 22 22 22 22 22 16 10 34 34 48 29 22 22 22 22 22 16 10 34 34 48 29 22 22 22 22 22 16 10 34 34 48 29 22 22 22 22 22 16 10 34 34 48 29 22
4 22 14 27 12 6 27 13 6 27 17 10 27 33 10 27 28 6 27 17 10 27 33 10 27 28 6 27 17 10 27 33 10 27 28 6 27 17 10 27 33 10 27 28 6 27 17 10 27 33 10 27 28 6 27 17 5 27 33 5 27 28 6 27 17 10 27 33 10 27 28 6 27 17 10 27 33 10 27 28
4 14 12 31 14 23 22 25 24 23 22 25 24 23 17 22 14 25 24 23 22 22 23 17 24 14 25 23 22 22 23 38 24 14 25 23 22 22 23 38 24 14 25 23 22 22 23 38 24 14 25 23 22 22 23 38 24 14 25 23 22 22 23 38 24 14 25 23 22 22 23 38 24 14 25 23 22 22 23 38
4 44 24 11 31 25 31 27 21 22 36 34 36 34 35 29 34 36 37 34 35 21 22 29 34 36 37 34 35 21 22 29 34 36 37 34 35 21 22 29 34 36 37 34 35 21 22 29 34 36 37 34 35 21 22 29 34 36 37 34 35 21 22 29 34 36 37 34 35 21 22 29 34 36 37 34 35 21 22 34
4 17 6 7 19 20 14 7 7 17 7 17 18 17 18 17 18 17 18 17 18 17 18 17 18 17 18 17 18 17 18 17 18 17 18 17 18 17 18 17 18 17 18 17 18 17 18 17 18 17 18 17 18 17 18 17 18 17 18 17 18 17 18 17 18 17 18 17 18 17 18 17 18 17 18 17 18 17 18 17
4 8 8 9 10 11 12 12 25 18 19 21 22 19 24 25 27 30 26 32 33 34 14 38 34 14 38 8 10 11 12 12 25 17 30 14 14 34 37
4 11 10 11 11 9 13 13 14 17 15 14 18 19 20 20 19 17 15 13 14 18 19 20 22 22 22 22 10 11 11 11 22 22 7
4 17 5 7 20 21 22 13 23 24 25 25 26 27 28 29 30 32 35 37 32 33 35 37 32 33 35 37 32 33 35 37 32 33 36 38
4 7 8 12 13 15 19 17 16 18 20 28 29 27 26 25 33 32 33 40 41 21 35 42 40 41 42 40 41 40 41 42 40 41
4 21 22 6 7 8 7 11 10 10 15 15 6 18 18 18 16 18 18 18 18 21 21 22 21 22 21 22 21 22 18 18 18 18
4 8 6 10 12 23 11 11 8 13 15 14 16 17 18 22 15 15 16 17 18 20 21 24 6 24 22 13 24 6 24 7 24 11 11
4 9 29 30 11 11 15 11 15 11 11 15 18 21 20 19 20 20 18 22 31 24 31 29 31 27 29 31 10 13 13 29 31 26 29
4 9 17 11 12 11 19 20 21 22 23 40 35 38 37 45 48 36 48 45 44 50 33 22 48 42 47 48 36 45 44 45 50 33 22 48 38
4 9 7 8 9 10 13 14 15 16 17 18 22 17 18 22 23 19 25 26 27 28 29 30 31 33 34 35 36 37 11 35 31 34
4 6 14 6 14 8 9 8 10 8 9 8 10 8 12 13 12 13 6 14 6 14 6 14 6 14 6 14 6 14 6 14 6 14
4 10 9 5 9 10 8 5 8 17 9 5 8 5 8 17 9 5 8 5 8 17 9 5 8 5 8 17 9 5 8 5 8 17 9 5 8 5 8 17 9 5 8 5 8 17 9 10 8 5 8 17 9 5 8 5 8 17 9 5 8 5 8 17 9 5 8 5 8 17 9 10 8 10 8 17 9 5 8 10
4 6 5 6 7 17 60 28 69 7 50 51 52 53 59 10 83 70 71 53 74 79 81 77 77 72 70 71 53 83 74 79 81 77
4 5 6 7 5 9 13 14 14 15 16 15 16 17 18 20 20 21 22 23 24 25 26 27 28 29 30 32 33 34 23 24 25 26 29 31 32 33 34
4 9 22 6 22 6 22 6 22 6 22 9 22 9 22 6 22 6 22 6 22 6 22 6 22 6 22 6 22 6 22 6 22 6 22 6 22 6 22 9 22 9 22 9 22 6 22 6 22 9 22 6 22 6 22 6 22 6 22 6 22 6 22 6 22 6 22 6 22 6 22 6 22 6 22 6 22 6 22 9
4 9 11 12 14 16 18 18 17 17 21 22 22 23 24 13 26 28 5 32 28 35 6 31 28 6 8 11 12 14 18 18 28 6 8 31
4 23 14 13 15 16 17 14 15 16 17 31 21 27 31 31 7 27 27 31 7 27 27 21 27 27 31 27 27 31 27 27 31 7
4 7 7 7 11 9 10 12 13 10 9 12 13 17 17 17 13 13 7 7 7 7 7 7 7 18 7 13 7 7 7 7 18 13
4 6 7 43 61 11 12 13 15 16 17 19 18 18 27 25 25 26 25 25 25 40 25 25 47 48 54 8 9 61 50 27 25 27
4 18 20 88 36 5 22 21 25 23 24 21 25 27 74 26 32 33 32 33 26 27 32 33 32 27 17 43 92 12 44 52 95 56 58 60 62 66 90 92 51
4 9 9 6 28 5 6 28 5 6 15 13 12 13 16 17 19 20 23 24 22 23 24 17 26 21 17 21 26 24 17 21 21 31
4 10 12 20 26 29 25 30 26 32 31 32 33 33 13 24 55 26 32 31 33 33 55 24 26 32 31 33 33 55 24 26 32 31 33 33 55 24 26 32 31 33 33 55 24 26 32 31 33 33 55 24 26 32 31 33 33 55 24 26 32 31 33 33 55 24 26 32 31 33 33 55 24 26 32 31 33 33 55 24
4 6 7 8 9 10 11 12 14 15 18 22 15 18 22 15 18 20 19 25 26 28 45 38 39 40 41 42 33 34 35 36 45 38
4 6 31 26 10 12 14 15 16 19 18 17 20 19 18 17 20 11 23 27 29 30 22 29 30 22 22 27 29 30 8 22 11 27 29 30
4 8 21 6 9 10 11 12 13 15 24 11 16 17 17 17 18 21 22 23 24 25 27 28 23 24 25 27 27 27 28 28 23 24 25
4 10 11 13 14 15 16 18 17 19 17 18 17 19 15 16 18 18 17 18 19 17 16 15 18 17 18 19 17 16 15 18 17 18 19 17 16 15 18 17 18 19 17 16 15 18 17 18 19 17 16 15 18 17 18 19 17 16 15 18 17 18 19 17 16 15 18 17 18 19 17 16 15 18 17 18 19 17 16 15
4 6 13 14 13 10 11 9 12 13 14 13 15 16 16 16 16 21 19 21 6 21 19 19 21 19 19 21 19 21 19 19 21 21
4 43 18 6 82 79 79 10 24 25 26 25 29 31 32 42 33 76 46 53 47 46 53 46 53 47 46 65 66 74 81 70 72 73
4 5 5 6 7 8 5 8 5 6 7 8 5 6 7 8 5 6 7 8 5 6 7 8 5 6 7 8 5 6 7 8 5 6 7 8 5 6 7 8 5 6 7 8 5 6 7 8 5 6 7 8 5 6 7 8 5 6 7 8 5 6 7 8 5 6 7 8 5 6 7 8 5 6 7 8 5 6 7 8
4 21 7 19 7 18 7 18 20 9 12 11 9 12 14 10 10 10 10 14 18 20 17 18 20 19 20 19 20 19 16 20 19 20
4 11 58 60 9 11 47 14 33 15 51 18 19 55 38 35 56 35 56 35 56 35 56 35 56 35 56 35 56 35 56 35 56 35 56 35 56 35 56 35 56 35 56 35 56 35 56 35 56 35 56 35 56 57 56 35 56 35 56 35 56 35 56 35 56 35 56 35 56 35 56 35 56 35 56 35 56 35 56 57
4 82 30 18 34 87 124 124 58 10 11 21 16 21 96 25 25 14 34 36 42 93 9 130 99 92 33 92 7 116 90 85 130 99 92 33 92 7 75 90 9 130 99 92 33 92 7 75 90 9 130 99 92 33 92 7 75 90 9 130 99 92 33 92 7 75 90 9 130 99 92 33 92 7 75 90 9 130 99 92
4 5 26 5 12 7 8 20 19 20 11 15 23 18 18 23 18 18 13 16 14 17 23 18 18 13 16 14 23 18 18 13 23 6 32 31 33 32 33
