4 8 11 10 14 15 16 12 19 18 20 21 21 21 7 7 24 24 24 24 23 24 24 23 24 24 24 24 23 24 24 24 24 23
4 22 7 8 8 16 16 17 16 21 21 21 18 21 21 17 19 21 21 21 18 21 21 17 19 21 21 21 18 21 21 17 19 21 21 22 14 11 24 27 27 14
4 13 19 28 21 29 29 29 29 29 29 29 29 29 29 29 29 29 29 29 29 29 29 29 29 29 29 29 29 29 29 29 29 29 29 29 29 29 29 29 29 29 29 29 29 29 29 29 29 29 29 29 29 29 29 29 29 29 29 29 29 29 29 29 29 29 29 29 29 29 29 29 29 29 29 29 29 29 29 29
4 6 7 14 12 16 14 12 16 14 12 16 14 12 16 14 12 16 14 12 16 14 12 16 14 12 16 14 12 16 14 12 16 14 12 16 14 12 16 14 12 16 14 12 16 14 12 16 14 12 16 14 12 16 14 12 16 14 12 16 14 12 16 14 12 16 14 12 16 14 12 16 14 12 16 14 12 16 14 12
4 5 18 5 6 7 10 12 10 13 14 11 15 17 17 15 17 22 11 9 13 11 15 17 17 15 17 22 11 9 13 11 15 17 17 15 17 22 11 9 13 11 15 17 17 15 17 22 11 9 13 11 15 17 17 15 17 22 11 9 13 11 15 17 17 15 17 22 11 9 13 11 15 17 17 15 17 22 11 9
4 6 8 37 36 34 8 14 10 10 15 20 21 16 17 25 18 24 25 12 12 31 31 38 11 12 12 31 31 38 12 14 10 10
4 7 6 7 7 7 7 11 10 10 15 13 18 13 18 14 19 20 19 22 6 7 6 7 14 18 13 18 13 15 19 22 20 19 17
4 6 10 24 22 23 20 22 19 19 19 19 19 19 20 22 19 19 19 19 19 19 20 22 19 19 19 19 19 19 20 22 19 19 19 19 19 19 20 22 19 19 19 19 19 19 20 22 19 19 19 19 19 19 20 22 19 19 19 19 19 19 20 22 19 19 19 19 19 19 20 22 19 19 19 19 19 19 20 22
4 7 6 10 7 14 14 15 16 18 19 14 15 16 18 19 16 25 24 22 28 32 37 36 35 36 12 35 36 12 12 35 36 12
4 9 6 7 7 10 10 12 12 21 14 16 16 16 18 9 18 9 21 22 21 22 21 22 7 9 13 21 22 7 9 21 22 21
4 7 24 20 29 38 38 41 45 44 43 44 43 47 44 46 47 44 43 44 43 47 44 46 47 44 43 44 43 47 44 46 47 44 43 44 43 47 44 46 47 44 43 44 43 47 44 46 47 44 43 44 43 47 44 46 47 44 43 44 43 47 44 46 47 44 43 44 43 47 44 46 47 44 43 44 43 47 44 46
4 9 8 6 10 13 8 6 10 13 16 6 16 6 10 8 6 10 13 16 6 16 6 16 6 16 19 6 16 19 6 16 19 19
4 5 6 20 20 20 20 20 20 19 9 20 20 20 20 20 19 9 20 20 20 20 20 23 23 24 25 25 25 26 22 19 12 10
4 17 10 11 7 8 13 10 22 18 18 23 24 25 26 25 26 27 20 26 25 20 23 23 24 25 26 25 26 27 20 26 25 20 23 23 24 25 26 25 26 27 20 26 25 20 23 23 24 25 26 25 26 27 20 26 25 20 23 23 24 25 26 25 26 27 20 26 25 20 23 23 24 25 26 25 27 26 25 26
4 9 7 8 9 10 11 12 13 14 15 14 16 19 18 17 18 17 18 19 20 22 23 24 25 26 27 30 31 32 33 34 35 35
4 5 13 71 88 5 25 24 23 24 24 33 32 42 44 40 44 40 42 44 40 31 42 44 40 44 40 42 44 40 31 42 44 40 44 40 42 44 40 31 42 44 40 44 40 42 44 40 31 42 44 40 44 40 42 44 40 31 42 44 40 44 40 42 44 40 31 42 44 40 44 40 42 44 40 31 42 44 40 44
4 20 8 9 14 16 19 19 15 20 18 23 17 18 20 24 22 23 25 25 42 7 29 48 32 33 34 35 36 37 38 39 39 41
4 7 5 6 12 5 5 8 5 7 8 5 11 11 11 15 15 15 7 6 7 9 12 7 9 12 7 9 12 7 9 12 7 12
4 5 38 14 15 16 13 14 15 16 13 14 15 16 5 18 19 19 20 22 23 20 17 22 23 20 23 24 5 19 20 22 23 20 5 26 27 31 28 30 39
4 5 8 10 9 10 10 9 10 10 10 9 10 10 10 9 10 10 10 9 10 10 10 9 10 10 10 10 9 10 10 10 10 9 10 10 10 10 9 10 10 10 10 9 10 10 10 9 10 10 10 10 9 10 10 10 10 9 10 10 10 10 9 10 10 10 10 9 10 10 10 9 10 10 10 10 9 10 10 10
4 21 8 7 10 9 10 9 7 10 9 7 10 9 7 10 9 7 10 9 7 10 9 7 10 9 7 10 9 7 10 9 7 10 9 7 10 9 7 10 9 7 10 9 7 10 9 7 10 9 7 10 9 7 10 9 7 10 9 7 10 9 7 10 9 7 10 9 7 10 9 7 10 9 7 10 9 7 10 9
4 33 9 6 10 13 13 12 13 13 12 13 13 12 13 13 12 13 13 12 13 13 12 13 13 12 13 13 12 13 13 12 13 13 12 13 13 12 13 13 12 13 13 12 13 13 12 13 13 12 13 13 12 13 13 12 13 13 12 13 13 12 13 13 12 13 13 12 13 13 12 13 13 12 13 13 12 13 13 12
4 5 14 15 16 17 17 16 17 21 16 17 21 5 17 8 8 9 10 7 22 7 10 11 22 7 10 7 22 7 7 10 11 22 10 7 7 22 7 10 11 22 10 7 7 22 7 10 11 22 7 10 7 22 7 7 10 11 22 10 7 7 22 7 10 11 22 10 7 7 22 7 10 11 22 7 10 7 22 7
4 10 6 21 6 8 8 14 17 15 15 11 18 12 19 19 19 19 18 12 12 11 18 12 19 19 19 19 21 22 21 22 21 22
4 7 8 8 9 12 14 15 11 14 11 13 13 13 13 7 8 9 12 14 15 11 14 11 13 13 13 13 7 8 9 12 14 15 11 9 13 13 13 13 5 22 23 7 8 9 12 15 11 14 9 13 13 13 13 7 8 9 12 14 15 11 14 11 13 13 13 13 7 8 9 12 14 15 11 9 13 13 13 13
4 32 6 31 11 13 9 10 12 15 19 18 14 17 16 16 29 22 26 29 22 26 29 34 30 35 30 35 38 15 19 18 7 16 16 29 22 26 29 22 26 29 34 30
4 29 21 7 7 7 7 7 7 10 8 7 8 7 8 7 8 7 8 7 8 7 8 7 8 7 8 7 8 7 8 7 8 7 8 7 8 7 8 7 8 7 8 7 8 7 8 7 8 7 8 7 8 7 8 7 8 7 8 7 8 7 8 7 8 7 8 7 8 7 8 7 8 7 8 7 8 7 8 7
4 8 28 8 9 12 14 15 15 16 17 16 17 18 19 19 19 25 26 26 7 26 26 7 26 7 26 7 26 7 26 26 7 26
4 11 9 25 9 26 11 12 13 17 17 18 34 20 21 22 23 21 23 17 14 13 17 20 21 22 23 21 23 17 14 13 17 20 21 22 23 21 23 17 14 13 17 20 21 22 23 21 23 17 14 13 17 20 21 22 23 21 23 17 14 13 17 20 21 22 23 21 23 17 14 13 17 20 21 22 23 21 23 17
4 16 9 21 9 21 12 8 14 9 14 12 12 16 12 14 12 16 12 8 14 12 14 12 16 12 8 16 16 12 12 14 12 16 8 14 12 14 12 16 12 8 16 16 12 12 16 12 14 8 14 12 14 12 16 12 8 16 16 12 12 14 12 14 8 14 12 14 12 16 12 8 14 14 12 12 14 12 14 8
4 5 7 10 27 25 7 19 29 7 31 29 7 31 26 7 31 7 19 7 24 29 7 31 26 7 31 26 7 31 7 19 7 24 29 7 31 29 7 31 26 7 31 7 19 7 24 29 7 31 29 7 31 26 7 31 7 19 7 24 29 7 31 29 7 31 26 7 31 7 19 7 24 29 7 31 29 7 31 29
4 5 6 12 8 9 18 19 20 15 22 19 19 18 20 15 22 24 25 25 26 25 25 25 26 25 25 25 26 25 25 25 26 25 25
4 14 6 7 8 10 13 12 13 12 14 16 15 16 17 17 20 20 20 20 20 20 20 20 20 20 20 20 20 20 20 20 20 20
4 6 7 8 9 6 12 11 12 13 14 16 17 20 18 19 22 21 24 25 26 27 28 29 35 30 31 32 33 33 34 37 36 37
4 15 28 7 13 28 12 15 17 16 18 18 19 20 21 19 21 22 19 20 21 19 21 23 24 24 23 24 11 31 29 12 22 20 19 21 30 24 24 23 24 11 31 29
4 29 6 19 9 10 11 12 13 14 15 16 15 17 29 29 29 24 26 27 24 26 19 27 24 26 19 27 24 21 23 23 27 24
4 20 13 64 68 6 27 28 30 29 33 32 32 37 38 40 41 39 42 39 42 41 39 42 39 42 41 39 42 39 42 41 39 42 39 42 41 39 42 39 42 41 39 42 39 42 41 39 42 39 42 41 39 42 39 42 41 39 42 39 42 41 39 42 39 42 41 39 42 39 42 41 39 42 39 42 41 39 42 39
4 8 7 7 7 17 7 22 20 21 22 20 21 20 21 22 21 20 21 20 21 20 21 20 21 20 21 20 21 20 21 20 21 22 21
4 8 24 9 7 8 10 11 10 10 12 13 12 13 12 13 12 14 14 12 13 12 13 12 14 14 12 13 12 13 12 14 14 12 13 12 13 12 14 14 12 13 12 13 12 14 14 12 13 12 13 12 14 14 12 13 12 13 12 14 14 12 13 12 13 12 14 14 12 13 12 13 12 14 14 12 13 12 13 12
4 13 31 45 32 35 36 33 37 38 34 40 42 42 28 56 52 9 17 56 52 7 56 47 56 47 56 47 56 52 56 47 56 47
4 32 6 23 17 18 19 20 38 21 22 24 22 24 10 36 29 37 44 45 47 50 51 51 11 12 12 41 44 45 50 51 11 51
4 13 23 6 8 15 15 14 15 17 18 13 20 19 20 21 20 21 20 21 13 6 8 13 9 20 21 20 21 20 21 13 23 6
4 5 7 8 17 7 6 13 12 11 13 14 15 6 14 15 19 8 17 7 17 18 18 18 18 7 17 18 18 18 7 17 18 18
4 55 55 46 10 21 23 22 24 32 39 41 42 41 42 44 34 43 55 55 47 63 55 55 47 59 55 47 63 55 47 51 55 47 63 55 55 47 59 55 47 63 55 47 51 55 47 63 55 55 47 59 55 47 63 55 47 51 55 47 63 55 55 47 59 55 47 63 55 47 51 55 47 63 55 55 47 59 55 47
4 5 11 12 7 16 17 18 19 20 22 22 23 26 25 29 32 35 39 38 37 38 8 37 38 8 37 38 8 8 37 38 8 8
4 6 12 5 5 5 5 7 7 7 7 7 7 7 7 7 7 7 7 7 7 7 7 7 7 7 7 7 7 7 7 10 11 11 12 12
4 52 32 26 9 48 29 16 17 18 20 19 19 22 23 24 22 23 24 22 24 25 33 24 22 23 24 22 23 24 25 33 24 22 23 24 22 23 24 25 33 24 22 23 24 22 23 24 25 33 24 22 23 24 22 23 24 25 33 24 22 23 24 22 23 24 25 33 24 22 23 24 22 23 24 25 33 24 22 23
4 23 19 7 33 24 28 33 34 28 7 33 28 28 7 33 28 7 7 33 28 28 7 33 28 28 7 33 28 28 7 33 28 7
4 5 16 10 8 14 9 11 15 14 11 15 16 23 22 20 21 23 20 24 24 23 24 23 24 23 24 23 24 23 24 23 24 24
4 5 6 7 5 10 13 11 12 17 15 16 15 16 15 17 26 15 16 15 17 26 15 16 13 15 16 17 26 15 16 15 17 26 15 16 15 16 17 26 15 16 15 17 26 15 16 15 17 26 15 16 15 17 26 15 16 15 17 26 15 16 15 17 26 15 16 15 17 26 15 16 15 17 26 15 16 15 17 26
4 10 8 6 5 9 12 12 13 14 15 18 12 12 13 14 15 18 12 12 13 14 15 18 12 12 13 14 15 18 12 12 13 14 15 18 12 12 13 14 15 18 12 12 13 14 15 18 12 12 13 14 15 18 12 12 13 14 15 18 12 12 13 14 15 18 12 12 13 14 15 18 12 12 13 14 15 18 12 12
4 6 9 36 14 26 6 17 20 18 19 17 20 22 23 22 23 22 23 22 23 22 23 22 23 22 23 22 23 22 23 22 23 22 23 22 23 22 23 22 23 22 23 22 23 22 23 22 23 22 23 22 23 22 23 22 23 22 23 22 23 22 23 22 23 22 23 22 23 22 23 22 23 22 23 22 23 22 23 22
4 19 8 42 10 20 13 12 22 14 24 24 24 42 17 42 17 44 17 11 13 12 22 23 24 24 24 42 17 42 17 44 17 11 13 12 22 14 24 24 24 42 17 42 17 44 17 11 13 12 22 14 24 24 24 42 17 42 17 44 17 11 13 12 22 14 24 24 24 42 17 42 17 44 17 11 13 12 22 23
4 5 6 7 9 8 9 8 12 9 11 10 11 11 6 10 11 11 6 11 10 11 11 12 9 9 11 10 11 11 6 10 11 11 12 9 11 10 11 11 6 10 11 11 6 11 10 11 11 12 9 9 11 10 11 11 6 10 11 11 12 9 11 10 11 11 6 10 11 11 6 11 10 11 11 12 9 11 10 11
4 5 59 84 34 41 63 56 57 72 46 46 49 48 48 48 47 51 11 37 89 59 60 59 63 24 78 83 76 78 59 60 9 60
4 14 11 11 7 7 9 10 11 12 12 16 18 15 18 18 16 17 16 17 11 17 16 17 16 17 11 17 16 17 16 17 11 17
4 13 9 27 27 5 30 33 32 31 30 40 50 51 68 38 61 68 47 61 68 47 61 68 47 61 68 47 61 68 47 61 68 47 61 68 47 61 68 47 61 68 47 61 68 47 61 68 47 61 68 47 61 68 47 61 68 47 61 68 47 61 68 47 61 68 47 61 68 47 61 68 47 61 68 47 61 68 47 61
4 8 6 9 10 13 11 15 16 18 20 19 21 22 21 22 24 10 29 16 9 10 13 11 15 16 18 20 19 21 22 21 22 10 23 22 21 22 27 23 18 20 19 21 22 22 24 10 7 16 9 10 13 11 15 16 18 20 19 21 22 21 22 27 23 22 21 22 27 23 18 20 19 21 22 22 24 27 7 16
4 9 9 10 13 14 16 17 18 15 19 21 21 21 19 21 8 32 32 30 34 35 36 37 38 39 43 35 41 41 41 38 39 42
4 14 23 10 24 14 15 6 17 17 13 14 15 9 10 24 14 15 6 17 17 13 14 15 9 10 24 11 6 17 12 13 14 15 9 10 24 11 6 17 12 13 14 15 9 10 24 11 6 17 12 13 14 15 9 10 24 11 6 17 12 13 14 15 23 10 24 11 6 17 12 13 14 15 9 10 24 11 6 17
4 8 10 29 10 12 13 18 20 22 23 24 25 27 25 27 29 30 30 32 30 31 32 30 31 32 9 30 31 32 9 30 32 30
4 53 37 37 31 42 40 45 46 43 44 43 44 51 49 50 51 52 53 54 52 54 54 52 54 54 54 52 54 54 54 52 54 54
4 8 13 11 39 13 14 15 14 16 14 14 15 16 22 23 21 23 24 25 27 28 46 25 30 32 33 30 32 32 33 30 32 32
4 9 7 10 10 9 20 21 19 9 20 21 10 9 20 21 10 9 20 21 10 9 20 21 10 9 20 21 10 9 20 21 10 9 20 21 10 9 20 21 10 9 20 21 10 9 20 21 10 9 20 21 10 9 20 21 10 9 20 21 10 9 20 21 10 9 20 21 10 9 20 21 10 9 20 21 10 9 20 21
4 13 15 13 14 6 16 16 11 12 13 14 15 9 10 6 16 11 12 13 14 15 16 16 12 13 14 15 9 10 15 16 11 12 13 14 15 9 10 15 16 11 12 13 14 15 9 10 15 16 11 12 13 14 15 9 10 15 16 11 12 13 14 15 9 10 15 16 11 12 13 14 15 9 10 15 16 11 12 13
4 5 11 13 9 15 15 14 17 19 20 21 21 21 21 21 11 26 26 26 32 36 30 7 33 33 33 36 26 26 36 30 7 33
4 15 7 8 9 10 11 12 11 12 15 15 15 18 21 20 18 18 21 20 18 18 21 20 18 18 21 20 18 18 21 20 18 21
4 14 8 12 11 15 17 18 19 20 22 19 20 22 9 12 11 15 17 18 19 20 22 19 20 22 9 12 11 15 17 18 19 20 22 19 20 22 9 12 11 15 17 18 19 20 22 19 20 22 9 12 11 15 17 18 19 20 22 19 20 22 9 12 11 15 17 18 19 20 22 19 20 22 9 12 11 15 17 18
4 7 6 13 23 26 27 19 28 19 32 35 39 31 40 42 14 44 44 31 40 48 51 44 45 51 53 45 42 44 48 51 44 41
4 18 8 20 8 9 11 12 13 14 15 16 17 18 18 20 21 22 23 24 25 26 27 28 29 28 29 22 23 24 25 26 27 28 29
4 6 11 21 14 12 15 13 24 19 21 19 23 20 23 20 17 5 26 28 29 5 28 30 29 5 28 29 5 27 28 30 29 5
4 18 19 20 20 20 18 20 20 18 20 19 20 20 20 18 20 18 20 19 20 20 18 20 18 20 18 20 19 20 20 20 18 20 18 20 19 20 20 18 20 18 20 19 20 20
4 20 7 26 7 26 11 11 13 12 15 18 17 19 16 19 16 19 19 16 19 26 8 25 26 22 26 25 26 8 26 25 26 22
4 40 11 15 45 48 51 23 54 54 54 34 65 63 49 50 64 63 65 66 64 63 65 66 64 66 75 91 74 10 25 77 78 79 95 89 83 77 78 79 89 95 39
4 10 8 9 10 13 8 11 32 9 10 18 21 22 23 23 27 28 27 29 30 30 30 11 13 32 34 9 9 11 11 11 9 34
4 6 36 11 8 9 21 23 23 22 24 28 24 28 32 7 34 40 43 42 43 42 13 8 43 19 19 43 42 17 43 42 13 8
4 6 7 7 8 11 9 10 12 13 14 16 16 17 6 19 6 19 19 6 19 21 22 23 25 24 25 19 19 24 25 19 24 25
4 9 7 7 10 11 13 11 12 14 22 16 18 19 9 23 19 19 6 21 23 19 19 6 21 23 19 19 6 21 23 19 19 6 9
4 13 14 13 15 14 13 15 16 17 13 14 15 16 13 14 15 16 13 14 15 16 13 14 15 16 13 14 15 16 13 14 15 16 13 14 15 16 13 14 15 16 13 14 15 16 13 14 15 16 13 14 15 16 13 14 15 16 13 14 15 16 13 14 15 16 13 14 15 16 13 14 15 16 13 14 15 16 13 14
4 11 12 11 13 15 24 16 18 17 20 19 20 19 26 32 26 26 21 37 23 8 38 39 38 37 23 8 38 38 29 39 38 21
4 40 16 16 23 30 29 27 36 38 39 38 39 40 41 42 46 43 43 49 44 20 44 20 44 20 44 20 44 20 44 20 44 20
4 8 6 22 8 7 6 10 8 11 15 9 11 17 15 17 17 21 21 21 21 21 21 23 22 6 18 7 22 5 7 10 23 21 21 21 21 23 22 6 18 7
4 7 9 10 13 13 14 15 13 18 22 22 23 26 27 24 26 8 29 31 37 29 34 31 37 29 31 31 37 29 31 31 37 29 31
4 5 13 5 10 11 5 14 15 18 17 18 17 18 17 18 22 22 22 23 13 24 9 24 23 6 24 6 24 22 19 23 9 24
4 9 26 14 10 15 16 17 18 17 18 17 18 17 21 21 21 21 11 12 26 23 23 31 23 31 8 23 23 27 29 8 23 23
4 27 7 64 25 19 11 8 10 11 9 8 14 12 15 14 15 19 37 35 50 44 25 46 37 41 59 46 51 21 62 63 63 61
4 25 25 27 26 30 29 31 34 35 36 37 38 36 37 38 8 11 16 16 10 26 27 30 29 31 34 35 36 37 38 38 32 11 16 16 10 10 27 26 29 31 34 35 36 37 38 38 32 23 16 16 10 26 27 30 29 31 34 35 36 37 38 38 32 23 16 16 16 16 27 26 29 31 34 35 36 37 38 38
4 5 40 24 25 26 28 27 26 5 25 28 26 27 5 34 35 36 8 36 9 13 13 13 13 17 6 25 30 26 28 27 30 26 23 25 28 26 27 5 34 35 36 8
4 23 7 7 6 7 11 11 15 13 17 18 17 18 14 14 14 16 17 18 17 18 14 20 21 19 19 20 21 6 22 25 26 27
4 9 7 8 20 10 10 13 14 35 15 17 16 19 18 19 18 17 19 18 19 18 17 19 18 19 18 19 18 17 19 18 19 18 19 18 17 19 18 19 18 19 18 17 19 18 19 18 19 18 17 19 18 19 18 19 18 17 19 18 19 18 19 18 17 19 18 19 18 19 18 17 19 18 19 18 19 18 17 19
4 5 10 29 26 12 12 8 10 29 14 16 15 16 19 20 21 24 24 10 29 26 12 29 12 29 10 29 29 29 17 29 17 29
4 51 19 31 31 14 38 37 36 21 36 24 37 22 21 37 22 24 37 22 21 37 22 24 37 22 21 37 22 24 37 22 21 37 22 24 37 22 21 37 22 24 37 22 21 37 22 24 37 22 21 37 22 24 37 22 21 37 22 24 37 22 21 37 22 24 37 22 21 37 22 24 37 22 21 37 22 24 37 22
4 11 8 14 13 24 26 22 27 25 29 32 33 31 34 30 30 32 33 31 34 30 30 32 33 31 34 30 30 30 32 33 31 34 30 30 30 32 33 31 34 30 30 30 32 33 31 34 30 30 30 32 33 31 34 30 30 30 32 33 31 34 30 30 30 32 33 31 34 30 30 30 32 33 31 34 30 30 32 33
4 6 6 34 18 33 17 19 20 21 42 32 29 22 21 38 6 33 32 20 21 30 32 29 22 21 38 6 34 33 17 19 20 21 42 32 29 22 21 38 6 33 32 20 21 30 32 29 22 21 38 6 34 33 17 19 20 21 42 32 29 22 21 38 6 33 32 20 21 30 32 29 22 21 38 6 33 32 20 21
4 17 9 10 6 7 12 12 12 14 15 16 16 19 19 7 21 21 7 15 8 9 7 15 8 6 7 15 8 6 7 15 8 6
4 27 6 17 18 18 18 19 21 22 23 23 24 26 26 6 27 30 32 31 30 32 32 30 27 32 30 7 11 33 27 32 30 32
4 19 10 10 10 16 34 34 34 8 15 48 29 22 22 22 22 34 34 34 19 21 48 29 22 22 22 22 34 34 34 19 8 15 48 29 22 22 22 22 34 34 34 19 21 48 29 22 22 22 22 34 34 34 19 8 15 48 29 22 22 22 22 34 34 34 19 21 48 29 22 22 22 22 34 34 34 19 8 15
4 10 5 28 17 14 27 27 14 27 28 6 27 29 14 27 33 6 27 17 14 27 33 6 27 17 14 27 33 6 27 17 14 27 33 6 27 17 14 27 33 6 27 17 14 27 33 6 27 17 14 27 33 6 27 17 14 27 33 6 27 17 14 27 33 6 27 17 14 27 33 6 27 17 14 27 33 6 27 17
4 14 12 13 6 23 22 23 24 25 22 23 24 25 22 23 24 52 28 42 42 42 51 47 11 9 54 42 42 35 51 15 47 9
4 35 24 11 30 31 25 31 21 29 34 36 34 36 34 37 34 35 21 22 29 34 36 34 36 34 37 34 35 27 21 22 34 36 34 36 34 37 34 35 21 22 29 34 36 34 36 34 37 34 35 27 21 22 34 36 34 36 34 37 34 35 21 22 29 34 36 34 36 34 37 34 35 27 21 22 34 36 34 34
4 13 12 13 12 9 11 13 12 13 12 13 12 13 12 9 13 12 13 12 13 12 13 12 9 13 12 13 12 13 12 13 19 20 21
4 5 5 8 9 10 11 12 8 36 9 10 11 12 25 18 19 19 24 25 17 29 26 32 33 34 14 38 33 34 14 38 33 34
4 11 10 11 10 11 17 13 13 14 17 18 19 18 18 20 19 18 18 20 22 22 22 10 11 11 11 11 11 11 11 11 11 7
4 10 5 12 20 20 21 22 24 24 23 24 25 26 28 28 32 30 35 32 35 36 37 39 38 9 8 39 14 9 8 39 14 8
4 13 8 8 12 15 19 17 16 18 20 28 29 27 26 25 33 32 39 40 35 42 40 41 42 40 41 40 41 21 41 42 40 41
4 21 16 16 21 7 8 7 11 10 10 10 15 15 6 18 18 18 16 21 16 21 21 22 21 22 21 22 21 22 21 22 21 22
4 8 6 10 8 11 11 5 15 16 17 18 22 15 15 16 17 18 22 15 15 16 17 18 22 15 15 16 17 18 22 21 20 21 24 9
4 20 21 20 19 20 20 18 19 20 20 22 24 31 29 24 31 6 29 31 27 13 29 31 6 29 31 27 13 29 31 6 29 31
4 16 17 17 11 11 19 12 18 41 18 12 19 21 24 21 22 35 37 49 47 48 45 44 50 36 49 36 48 36 49 36 48 36
4 9 7 8 6 10 13 14 15 16 17 18 22 17 18 22 23 19 25 25 26 27 28 29 30 31 32 33 34 36 35 31 33 34
4 6 14 6 14 8 9 8 8 10 10 8 12 13 12 13 6 6 14 6 14 6 14 6 14 6 14 6 14 6 14 6 14 6
4 10 6 9 10 9 6 18 5 18 6 18 10 18 6 18 5 18 6 18 5 18 6 18 5 18 6 18 5 18 6 18 5 18 6 18 5 18 6 18 5 18 6 18 5 18 6 18 5 18 6 18 5 18 6 18 10 18 6 18 10 18 6 18 5 18 6 18 5 18 6 18 5 18 6 18 5 18 6 18
4 40 5 40 45 13 7 50 60 7 50 60 16 50 60 7 50 60 7 50 60 7 50 60 7 50 60 7 50 60 7 50 60 7 50 60 7 50 60 7 50 60 7 50 60 7 50 60 7 50 60 7 50 60 7 50 60 7 50 60 7 50 60 7 50 60 7 50 60 7 50 60 7 50 60 7 50 60 7 50
4 5 6 7 5 9 13 10 15 16 14 15 16 17 18 19 20 20 21 22 23 24 25 26 29 31 32 33 34 23 25 26 29 31 32 33
4 9 7 22 9 10 11 12 13 14 15 16 17 18 18 17 18 14 15 16 17 18 18 17 18 14 15 16 17 18 18 17 18 14 15 16 17 18 18 17 18 14 15 16 17 18 18 17 18 14 15 16 17 18 18 17 18 14 15 16 17 18 18 17 18 14 15 16 17 18 18 17 18 14 15 16 17 18 18 17
4 9 11 12 14 18 15 21 21 23 24 13 26 22 22 21 24 13 26 22 21 23 24 25 26 22 22 21 24 13 26 22 21 23 24 13 26 22 22 21 24 13 26 22 21 23 24 13 26 22 22 21 24 13 26 22 21 23 24 13 26 22 22 21 24 13 26 22 21 23 24 13 26 22 22 21 24 25 26 5
4 11 13 14 15 16 17 14 13 15 17 14 15 16 17 14 13 15 17 17 31 21 27 27 31 31 27 27 31 27 27 31 27 27
4 15 7 18 7 11 9 10 12 13 9 11 9 12 13 9 11 9 12 13 9 11 9 12 13 9 10 12 13 9 11 9 12 13 9 11 9 12 13 9 11 10 12 13 9 11 9 12 13 9 10 12 13 9 11 9 12 13 9 11 10 12 13 9 11 9 12 13 9 10 12 13 9 11 9 12 13 9 11 9
4 6 7 25 11 12 13 13 13 15 16 17 19 18 19 18 16 17 19 18 19 18 16 17 19 18 19 18 16 17 19 18 19 18 16 17 19 18 19 18 16 17 19 18 19 18 16 17 19 18 19 18 16 17 19 18 19 18 16 17 19 18 19 18 16 17 19 18 19 18 16 17 19 18 19 18 16 17 19 18
4 34 11 6 24 21 25 23 92 26 26 32 33 38 27 27 29 43 74 94 51 52 54 56 60 68 90 92 51 51 55 52 53 58 96 66 68 90 92 51
4 9 9 6 28 5 6 6 11 19 13 12 16 17 19 22 23 24 25 22 25 24 7 6 8 26 21 17 26 21 24 17 26 21
4 10 16 28 27 29 25 30 50 26 32 31 33 33 51 13 50 28 26 27 29 25 30 50 26 32 31 33 33 51 41 50 28 26 27 29 25 30 50 26 32 31 33 33 51 13 50 28 26 27 29 25 30 50 26 32 31 33 33 51 13 50 28 26 27 29 25 30 50 26 32 31 33 33 51 17 50 28 26 27
4 9 7 8 9 10 11 12 13 14 15 18 22 15 18 22 23 19 20 19 25 25 26 40 41 42 33 34 35 36 45 38 49 49
4 9 11 6 31 26 10 12 14 14 15 16 17 16 19 18 17 20 11 16 19 18 17 20 16 19 18 17 20 16 19 18 17 20 16 19 18 17 20 16 19 18 17 20 16 19 18 17 20 16 19 18 17 20 16 19 18 17 20 11 16 19 18 17 20 16 19 18 17 20 16 19 18 17 20 16 19 18 17 20
4 18 6 9 10 11 12 13 24 11 10 11 12 13 17 16 17 17 17 16 17 17 17 17 22 23 24 25 27 27 26 27 27 27
4 10 7 5 11 14 15 16 18 17 19 17 16 15 18 18 17 18 19 15 16 18 18 17 18 19 15 16 18 17 18 18 19 15 16 18 17 18 18 19 15 16 18 17 18 18 19 15 16 18 17 18 18 19 15 16 18 17 18 18 19 15 16 18 17 18 18 19 15 16 18 17 18 18 19 15 17 16 18 18
4 7 19 6 8 8 9 10 11 13 14 13 15 16 16 16 16 21 21 19 21 21 19 21 21 19 21 21 19 21 21 19 21 21
4 43 18 10 25 24 25 72 29 32 32 42 42 49 76 46 53 64 46 73 73 66 74 81 70 72 73 73 75 66 74 69 70 72
4 14 9 8 5 6 7 10 11 12 13 11 12 10 11 12 13 17 16 15 20 23 25 26 27 29 28 29 28 29 28 30 29 28
4 16 7 19 7 11 11 9 12 10 10 14 10 10 10 10 14 10 10 10 9 10 14 10 10 10 10 14 10 10 10 9 10 14 10 10 10 10 14 10 10 10 9 10 14 10 10 10 10 14 10 10 10 9 10 14 10 10 10 10 14 10 10 10 9 10 14 10 10 10 10 14 10 10 10 9 10 14 10 10
4 65 60 63 47 33 33 32 34 18 36 55 38 57 38 57 55 36 37 38 57 38 57 55 36 37 38 57 38 57 55 36 37 38 57 38 57 55 36 37 38 57 38 57 55 36 37 38 57 38 57 55 54 37 38 57 38 57 55 36 37 38 57 38 57 55 36 37 38 57 38 35 20 36 37 38 57 38 57 55
4 33 81 126 30 10 20 21 16 25 25 25 25 42 93 43 82 25 42 93 85 130 99 99 7 116 85 130 99 99 7 58 89 116 85 130 97
4 5 12 7 8 20 20 11 15 16 18 18 18 18 18 18 18 18 18 18 18 18 18 18 18 18 18 18 18 18 18 18 18 18 18 18 18 18 18 18 18 18 18 18 18 18 18 18 18 18 18 18 18 18 18 18 18 18 18 18 18 18 18 18 18 18 18 18 18 18 18 18 18 18 18 18 18 18 18 18
