4 8 5 7 7 10 11 14 10 14 15 12 13 19 18 23 20 21 21 7 7 7 7 7 7 7 7 7 7 7 10 11 14 10 14 15 12 13 19 18 23 20 21 21 7 7 7 7 7 7 7 7 7 7 7 10 11 14 10 14 15 12 13 19 18 23 20 21 21 7 7 7 7 7 7 7 7 7 7 7
4 22 7 12 12 13 17 16 16 17 21 21 21 21 18 21 21 21 17 21 21 21 18 21 21 21 17 21 21 21 18 21 21 21 17 21 21 21 18 21 21 21 17 21 21 21 18 21 21 21 17 21 21 21 18 21 21 21 17 21 21 21 18 21 21 21 17 21 21 21 18 21 21 21 17 21 21 21 18 21
4 7 18 29 29 29 29 29 29 29 29 29 29 29 29 29 29 29 29 29 29 29 29 29 29 29 29 29 29 29 29 29 29 29 29 29 29 29 29 29 29 29 29 29 29 29 29 29 29 29 29 29 29 29 29 29 29 29 29 29 29 29 29 29 29 29 29 29 29 29 29 29 29 29 29 29 29 29 29 29
4 13 13 14 15 13 14 15 13 14 15 13 14 15 7 14 15 6 14 15 7 14 15 6 14 15 7 14 15 6 14 15 7 14 15 6 14 15 7 14 15 6 14 15 7 14 15 6 14 15 7 14 15 6 14 15 7 14 15 6 14 15 7 14 15 6 14 15 7 14 15 6 14 15 7 14 15 13 14 15
4 5 5 20 5 6 7 7 7 12 10 14 11 17 15 17 17 15 17 17 15 17 17 15 17 17 15 17 17 15 17 17 15 17 17 15 17 17 15 17 17 15 17 17 15 17 17 15 17 17 15 17 17 15 17 17 15 17 17 15 17 17 15 17 17 15 17 17 15 17 17 15 17 17 15 17 17 15 17 17
4 6 7 9 8 9 8 10 20 16 17 25 18 21 22 16 17 25 12 12 31 38 35 38 11 12 31 38 38 11 30 31 38 38
4 21 6 7 7 5 11 10 13 18 13 14 18 13 14 15 22 19 19 19 19 19 6 17 7 6 7 7 6 7 7 6 7 7 7 6 7 7 7 6 7 7 7 7 6 7 7 7 11 10 13 18 13 14 15 22 19 19 19
4 43 14 37 6 24 23 23 20 22 19 19 19 19 19 22 19 19 19 19 20 22 19 19 19 19 19 22 19 19 19 19 20 22 19 19 19 19 19 22 19 19 19 19 20 22 19 19 19 19 19 22 19 19 19 19 20 22 19 19 19 19 19 22 19 19 19 19 20 22 19 19 19 19 19 22 19 19 19 19
4 9 11 8 11 14 14 15 16 18 18 19 15 16 23 26 22 31 29 32 33 32 34 36 35 12 35 12 32 33 32 34 36 35
4 5 6 7 7 5 10 10 12 12 21 14 16 16 16 22 18 22 21 21 22 21 21 21 18 9 7 9 21 21 22 21 21 9
4 6 17 29 38 38 38 19 20 29 38 38 38 49 20 29 38 38 38 19 20 29 38 38 38 19 20 29 38 38 38 19 20 29 38 38 38 19 20 29 38 38 38 19 20 29 38 38 38 19 20 29 38 38 38 19 20 29 38 38 38 19 20 29 38 38 38 19 20 29 38 38 38 19 20 29 38 38 38 37
4 5 8 6 10 10 10 10 10 8 6 10 10 10 10 10 8 10 10 11 10 10 6 10 10 8 10 10 10 10 6 10 10 8 6 10 10 10 10 10 10 8 6 10 10 10 10 10 8 6 10 10 10 10 10 8 6 10 10 10 10 10 8 6 10 10 10 10 10 8 6 10 10 10 10 10 8 10 10 10
4 5 7 10 7 12 5 7 8 7 8 7 8 14 20 8 7 8 9 17 8 7 8 9 20 8 7 8 9 20 8 7 8 9 20 8 7 8 9 20 8 7 8 9 20 8 7 8 14 20 8 7 8 9 20 8 7 8 9 20 8 7 8 9 20 8 7 8 9 20 8 7 8 9 20 8 7 8 5 20
4 28 17 11 13 7 36 11 10 22 19 18 25 26 27 26 25 27 20 26 25 27 20 31 8 31 31 9 7 34 7 34 7 34
4 5 9 7 8 9 10 20 11 13 12 12 13 14 16 17 18 17 19 22 22 23 24 25 26 27 28 29 30 32 33 33 34 35
4 5 9 49 17 25 24 25 24 23 32 39 32 42 24 32 42 24 32 39 32 42 24 32 42 24 32 39 32 42 24 32 42 24 32 39 32 42 24 32 42 24 32 39 32 42 24 32 42 24 32 39 32 42 24 32 42 24 32 39 32 42 24 32 42 24 32 39 32 42 24 32 42 24 32 39 32 42 24 32
4 29 8 30 8 9 14 16 19 19 19 18 21 24 17 18 20 24 23 22 20 24 17 18 20 24 23 17 18 20 24 23 22 20 24 17 18 20 24 23 17 18 20 24 23 22 20 24 17 18 20 24 23 17 18 20 24 23 22 20 24 17 18 20 24 23 17 18 20 24 23 22 20 24 17 18 20 24 23 17
4 6 5 5 5 12 5 5 5 5 5 5 8 8 11 11 11 11 11 15 7 9 9 12 15 7 9 9 9 12 9 9 12 7
4 5 9 14 15 16 13 14 15 16 9 14 39 13 19 19 20 22 23 20 21 24 37 15 27 28 28 39 34 39 24 24 39 11
4 5 5 8 9 9 10 10 10 9 10 10 10 9 10 10 9 10 10 10 9 10 10 10 9 10 10 10 9 10 10 10 9 10 10 10 9 10 10 10 9 10 10 10 9 10 10 10 9 10 10 10 9 10 10 10 9 10 10 10 9 10 10 10 9 10 10 10 9 10 10 10 9 10 10 10 9 10 10 10
4 21 8 7 10 9 6 11 12 13 14 14 11 12 13 13 18 19 20 20 22 25 25 25 9 23 25 25 9 24 25 25 9 22
4 11 6 18 6 13 10 13 12 13 13 12 13 12 13 13 12 13 10 13 13 12 13 13 12 13 13 12 13 10 13 13 12 13 13 12 13 13 10 13 12 13 13 12 13 12 13 13 12 13 10 13 13 12 13 13 12 13 13 12 13 10 13 13 12 13 13 12 13 13 10 13 12 13 13 12 13 12 13 13
4 5 14 13 5 17 11 10 8 8 8 9 10 11 10 7 22 11 10 7 7 22 11 10 7 7 22 11 10 7 22 27 28 18 19 23
4 7 6 21 6 9 6 8 8 17 18 15 11 15 15 18 12 19 19 19 9 21 22 22 22 22 9 22 22 22 22 22 22 22
4 7 7 8 8 9 12 14 15 14 11 13 13 13 14 9 14 12 14 15 14 11 13 13 13 14 9 14 12 14 15 14 11 13 13 13 14 9 14 12 14 15 14 11 13 13 13 14 9 14 12 14 15 14 11 13 13 13 14 9 14 12 14 15 14 11 13 13 13 14 9 14 12 14 15 14 11 13 13 13
4 32 6 31 8 11 13 10 9 12 15 19 18 18 7 16 16 22 22 26 28 34 7 35 30 35 38 15 26 28 28 33 25 35
4 22 6 7 7 9 7 7 7 7 9 18 18 20 19 19 19 19 19 19 20 19 19 19 19 19 19 19 20 19 19 19 19 19 19 20 19 19 19 19 19 19 20 19 19 19 19 19 19 20 19 19 19 19 19 19 20 19 19 19 19 19 19 20 19 19 19 19 19 19 20 19 19 19 19 19 19 20 19 21
4 5 6 28 8 25 8 12 14 11 17 16 18 19 19 19 7 26 26 26 7 26 26 26 7 26 26 26 7 26 26 26 7 26
4 28 5 9 7 9 26 9 26 9 26 9 26 9 26 9 26 9 26 9 26 9 26 9 26 9 26 9 26 9 26 9 26 9 26 9 26 9 26 9 26 9 26 9 26 9 26 9 26 9 26 9 26 9 26 9 26 9 26 9 26 9 26 9 26 9 26 9 26 9 26 9 26 9 26 9 26 9 26 9
4 13 9 21 9 8 6 9 21 9 21 9 8 6 9 21 9 21 9 8 6 9 21 9 21 9 8 6 9 21 9 21 9 8 6 9 21 9 21 9 8 6 9 21 9 21 9 8 6 9 21 9 21 9 8 6 9 21 9 21 9 8 6 9 21 9 21 9 8 6 9 21 9 21 9 8 6 9 21 9
4 22 27 10 7 25 7 26 30 27 30 7 31 7 30 7 30 26 30 27 30 7 30 7 30 7 30 26 30 27 30 7 30 7 30 7 30 26 30 27 30 7 30 7 30 7 30 26 30 27 30 7 30 7 30 7 30 26 30 27 30 7 30 7 30 7 30 26 30 27 30 7 30 7 30 7 30 29 30 27
4 33 7 6 27 31 8 9 18 18 20 30 22 25 25 26 26 26 29 28 29 29 21 31 29 21 31 32 27 31 32 32 28 6 27 28 8 9 18 18 20 30 22 25 25 26 26 26 29 28
4 7 6 7 8 10 12 13 13 12 13 13 12 13 9 16 15 16 18 15 17 20 17 20 20 15 17 20 20 14 14 19 14 8
4 10 7 9 10 12 11 13 13 14 16 17 20 18 19 18 22 21 24 9 34 25 26 27 28 29 30 32 33 32 33 36 37 37
4 8 8 12 15 12 12 10 16 17 16 20 21 19 20 21 22 19 20 21 23 24 24 25 27 29 28 29 12 28 12 9 28 29
4 5 6 19 8 9 10 12 11 13 14 15 16 17 29 29 29 25 26 19 27 26 7 27 26 7 27 24 26 7 27 26 7 27
4 6 20 16 72 20 27 28 29 33 32 32 37 37 39 42 42 42 41 38 34 38 39 42 41 38 39 42 42 41 38 39 42 42 41 38 39 42 42 41 38 39 42 42 41 38 39 42 42 41 38 39 42 42 41 38 39 42 42 41 38 39 42 42 41 38 39 42 42 41 38 39 42 42 41 38 39 42 42 41
4 19 9 17 17 17 17 17 17 17 17 17 17 17 17 17 17 17 17 17 17 17 17 17 17 17 17 17 17 17 17 17 17 17 17 17 17 17 17 17 17 17 17 17 17 17 17 17 17 17 17 17 17 17 17 17 17 17 17 17 17 17 17 17 17 17 17 17 17 17 17 17 17 17 17 17 17 17 17 17
4 9 5 8 16 24 10 11 10 13 12 13 12 14 7 16 20 20 20 22 20 20 20 22 20 20 20 22 20 20 20 22 20 20
4 48 5 8 18 32 35 37 34 40 42 42 42 42 45 56 23 47 56 47 17 17 17 7 17 7 17 7 17 7 17 7 17 7 17 7 18 32 35 37 34 40 42 42 42 42 45 56 23 47
4 6 6 23 17 18 19 20 30 21 22 24 24 22 24 46 10 29 29 45 47 48 40 50 51 51 30 15 36 44 45 47 48 50 51 51
4 13 10 8 8 8 8 15 15 14 17 18 16 13 19 19 20 21 20 21 20 6 8 8 9 8 9 8 9 8 9 8 8 9 8 8 9 8 9 8 9 8 8 8 8 8 8 8 8 8 15 15 14 17 18 16 13 19 19 20 21 20
4 19 5 7 8 17 7 12 11 13 12 14 15 18 19 8 8 17 19 17 18 18 18 18 18 18 18 19 9 8 17 7 17 18
4 16 19 15 21 23 22 24 23 22 37 35 41 42 41 42 35 43 55 55 55 55 59 47 67 73 75 70 70 73 75 70 70 68
4 6 6 14 13 16 17 18 19 19 20 22 25 30 25 30 27 29 32 35 33 34 38 37 14 37 14 14 37 14 14 10 7 10 12 7 12 16 17 18 19 19 20 22 25 30 25 30 27 29 32 35 33 34 38 37 14
4 6 6 5 5 5 6 7 7 7 7 7 7 7 7 7 7 7 7 7 7 7 7 7 7 7 7 7 7 7 7 7 7 7 7 7 7 7 7 7 7 7 7 7 7 7 7 7 7 7 7 7 7 7 7 7 7 7 7 7 7 7 7 7 7 7 7 7 7 7 7 7 7 7 7 7 7 7 7 7
4 52 15 26 26 48 48 29 29 13 29 16 17 20 20 20 19 23 31 22 24 21 33 82 36 39 39 48 48 48 48 13 29 16 17 20 20 20 19 23 31 22 24 21 33 82 36 39 39 48 48 48 48 13 29 16 17 20 20 20 19 23 31 22 24 21 33 82 36 39 39 48 48 48 48 48 29 16 17 20
4 23 9 10 10 13 13 14 15 16 16 16 11 16 11 16 16 11 16 16 11 16 16 11 16 16 11 16 16 11 16 11 16 16 11 16 16 11 16 16 11 16 11 16 16 11 16 16 11 16 16 11 16 11 16 16 11 16 16 11 16 16 11 16 11 16 16 11 16 16 11 16 16 11 16 11 16 16 16 11
4 18 6 8 9 12 9 11 14 10 8 12 9 15 11 14 10 16 8 12 9 15 11 14 10 8 12 9 15 11 14 10 16 8 12 9 15 11 14 10 8 12 9 15 11 14 10 16 8 12 9 15 11 14 10 8 12 9 15 11 14 10 16 8 12 9 15 11 14 10 8 12 9 15 11 14 10 16 8 12
4 8 6 20 8 13 12 11 16 15 17 15 16 17 26 22 27 28 23 28 23 26 23 19 20 23 22 28 26 23 23 28 28 26
4 10 8 6 7 12 11 13 14 15 18 12 12 13 14 15 18 16 16 17 18 9 8 9 14 5 18 9 14 5 8 9 10 12 11 13 14 15 18 16 17
4 9 9 26 11 36 14 26 14 26 14 26 14 26 14 26 14 26 14 26 14 26 14 26 14 26 14 26 14 26 14 26 14 26 14 26 14 26 14 26 14 26 14 26 14 26 14 26 14 26 14 26 14 26 14 26 14 26 14 26 14 26 14 26 14 26 14 26 14 26 14 26 14 26 14 26 14 26 14 26
4 19 10 42 10 20 22 13 12 13 23 24 24 13 13 14 24 13 13 23 24 13 24 13 14 24 13 13 23 24 13 24 13 14 24 13 13 23 24 13 24 13 14 24 13 13 14 24 13 24 13 23 24 13 13 23 24 13 24 13 14 24 13 13 23 24 13 24 13 14 24 13 13 23 24 13 24 13 14 24
4 5 5 6 7 9 8 8 12 11 10 11 11 6 11 10 11 11 6 10 11 11 6 11 10 11 11 6 10 11 11 6 6 16 17 18 19 20
4 5 59 6 55 100 70 108 46 46 49 48 48 49 51 37 13 93 85 82 18 59 58 59 58 78 83 83 85 82 58 59 66 78
4 14 14 11 6 8 7 7 9 10 11 12 11 12 18 15 18 15 17 17 15 17 11 17 15 18 11 17 15 17 11 17 15 17
4 10 9 27 5 30 30 31 30 30 31 50 51 42 54 66 54 66 54 66 33 46 8 83 106 12 92 16 106 20 20 20 20 19
4 24 8 29 6 9 13 11 14 15 16 18 20 19 21 22 22 21 22 22 21 22 22 21 22 22 21 22 22 21 22 22 21 22 22 21 22 22 21 22 22 21 22 22 21 22 22 21 22 22 21 22 22 21 22 22 21 22 22 21 22 22 21 22 22 21 22 22 21 22 22 21 22 22 21 22 22 21 22 22
4 9 9 23 5 11 10 13 12 16 14 18 15 19 21 21 21 8 28 32 34 34 34 35 36 37 38 39 43 35 41 41 41 40
4 9 7 15 8 16 10 24 7 15 22 23 10 24 14 15 17 12 13 21 20 21 20 10 24 7 24 11 7 15 6 15 22 7 15 8 6 10 24 7 15 16 17 12 13 21 20 21 20 7 24 7 11
4 8 6 29 6 13 18 20 19 23 24 25 25 27 29 30 30 30 30 30 30 30 30 30 30 30 30 30 30 30 30 30 30 30
4 16 14 57 22 14 42 42 40 45 46 43 44 43 44 51 49 8 51 52 25 36 52 54 54 54 52 54 54 54 52 54 54 54
4 10 6 11 44 13 11 14 14 16 14 14 14 22 20 20 20 22 46 24 27 40 40 9 9 30 33 27 32 24 27 40 9 9 30
4 9 8 19 10 20 7 20 7 20 7 20 7 20 7 20 7 20 7 20 7 20 7 20 7 20 7 20 7 20 7 20 7 20 7 20 7 20 7 20 7 20 7 20 7 20 7 20 7 20 7 20 7 20 7 20 7 20 7 20 7 20 7 20 7 20 7 20 7 20 7 20 7 20 7 20 7 20 7 20
4 15 15 9 14 15 16 11 12 11 11 12 20 20 19 20 9 10 13 14 8 9 10 14 8 16 11 12 20 20 19 9 10 10
4 12 12 11 13 9 15 15 14 17 18 21 20 17 20 21 21 11 26 26 26 32 35 34 30 30 33 33 33 33 36 36 36 36
4 7 8 8 9 10 11 12 11 11 12 15 15 15 15 18 21 18 18 21 18 21 18 21 18 21 18 21 18 21 18 21 18 21
4 5 7 8 12 15 13 14 17 18 20 22 19 20 22 14 12 14 15 17 18 8 20 22 19 20 22 9 14 12 15 13 14 17 18 19 20 22 19 20 22 9 14 12 13 15 17 18 8 20 22 19 20 22 14 12 14 15 17 18 8 20 22 19 20 22 9 14 12 13 15 17 18 8 20 22 19 20 22 9
4 6 6 15 18 25 17 27 27 28 32 29 35 35 35 39 31 53 47 14 44 51 10 31 53 52 52 42 14 44 51 10 31 53 52 52 47 14 44 51 10 31 53 52 52 42 14 44 51 10 31 53 52 52 42 14 44 51 10 23
4 18 8 20 6 9 9 12 11 12 13 13 15 17 15 17 18 7 21 7 22 23 24 25 27 28 28 29 22 23 24 25 27 28
4 6 10 7 8 12 12 19 12 15 16 14 19 23 20 20 20 17 17 7 26 28 30 29 5 31 31 30 27 29 5 24 27 28
4 7 5 18 20 20 19 20 20 20 20 20 20 19 20 9 18 20 19 20 9 18 20 19 20 9 18 20 19 20 9 18 20 19 20 9 18 20 19 20 9 18 20 19 20 9 18 20 19 20 9 18 20 19 20 9 18 20 19 20 9 18 20 19 20 9 18 20 19 20 9 18 20 19 20 9 18 20 19 20
4 5 7 26 7 22 11 11 13 14 12 15 18 17 19 19 19 19 16 19 19 19 19 16 19 19 19 19 19 16 19 19 19 19 19 16 19 19 19 19 19 16 19 19 19 19 19 16 19 19 19 19 19 16 19 19 19 19 19 16 19 19 19 19 19 16 19 19 19 19 19 16 19 19 19 19 19 16 19 19
4 10 10 11 45 18 51 54 24 24 50 32 65 63 49 50 32 65 33 65 64 59 34 75 91 91 74 77 78 79 95 89 86 98
4 6 8 9 32 13 21 22 24 25 24 29 29 30 30 11 9 34 9 32 34 9 32 9 21 22 27 28 24 29 30 30 30 11 9
4 9 36 11 9 15 23 23 22 26 28 32 33 34 33 40 43 42 43 44 11 8 8 43 42 19 43 44 11 8 8 43 42 17
4 6 7 17 17 20 7 8 11 9 10 12 14 13 13 14 16 16 17 6 17 17 6 17 22 23 25 25 25 25 25 25 19 19
4 5 6 7 7 10 11 13 11 11 12 14 22 19 16 18 19 21 19 9 22 23 23 19 19 9 23 22 23 23 19 19 23 23
4 8 9 20 21 7 9 19 12 12 12 14 16 13 14 15 16 13 14 15 16 13 14 15 16 13 14 15 16 13 14 15 16 13 14 15 16 13 14 15 16 13 14 15 16 13 14 15 16 13 14 15 16 13 14 15 16 13 14 15 16 13 14 15 16 13 14 15 16 13 14 15 16 13 14 15 16 13 14 15
4 22 6 21 6 21 11 12 13 11 15 16 18 17 20 19 19 26 26 26 26 32 32 32 32 32 31 32 32 32 31 32 32 32 31 32 26 26 25 26 32 32 31 32 32 32 31 32 32 32 31 32 32 32 31 32 32 32 31 32 32 32 31 32 32 32 31 32 32 32 31 32 32 32 31 32 32 32 31 32
4 48 30 20 30 29 29 27 32 38 39 38 39 40 40 41 42 46 43 49 44 20 44 20 44 20 44 20 44 20 44 20 44 20
4 5 6 6 22 6 7 6 7 6 7 6 7 6 22 6 7 6 7 6 7 6 7 6 22 6 7 6 7 6 7 6 7 6 22 6 7 6 7 6 7 6 7 6 22 6 7 6 7 6 7 6 7 6 22 6 7 6 7 6 7 6 7 6 22 6 7 6 7 6 7 6 7 6 22 6 7 6 7 6
4 9 7 10 43 12 10 13 13 15 13 13 13 21 19 19 18 19 20 20 23 26 39 39 8 29 28 33 31 26 31 39 39 8 29 28 33
4 5 11 12 13 10 8 10 7 8 11 11 8 13 10 8 10 7 8 11 11 8 13 10 8 10 7 8 11 11 8 13 10 8 10 7 8 11 11 8 13 10 8 10 7 8 11 11 8 13 10 8 10 7 8 11 11 5 13 10 8 10 7 12 11 11 8 13 10 12 10 7 8 11 11 8 13 10 5 10
4 9 9 11 7 14 10 15 16 17 18 17 18 21 21 21 30 23 23 31 23 31 23 31 23 31 23 31 23 31 23 31 23 31
4 31 7 64 7 10 11 11 9 8 14 12 15 14 15 15 14 15 15 51 18 36 25 46 44 25 53 44 25 53 58 48 53 44 25 53 44 25 53 44 25 53 44 25 53 44 25 53 44 25 53 44 25 53 44 25 53 44 25 53 44 25 53 44 25 53 44 25 53 44 25 53 44 25 53 44 25 53 44 25
4 20 25 27 26 29 30 31 34 35 36 37 38 38 32 22 18 41 10 45 25 27 26 29 31 34 35 36 37 38 38 32 16 18 41 10 45 25 27 26 29 31 34 35 36 37 38 38 32 16 18 41 10 45 25 27 26 29 31 34 35 36 37 38 38 32 16 18 41 16 45 25 27 26 29 31 34 35 36 37
4 23 14 20 21 22 14 20 21 22 10 20 21 22 10 20 21 22 10 20 21 22 10 20 21 22 10 20 21 22 10 20 21 22 10 20 21 22 10 20 21 22 10 20 21 22 10 20 21 22 10 20 21 22 10 20 21 22 10 20 21 22 10 20 21 22 10 20 21 22 10 20 21 22 10 20 21 22 10 20
4 7 7 6 7 11 15 13 17 18 17 18 17 16 20 21 21 20 22 23 27 25 27 27 25 27 27 25 27 27 25 27 27 25
4 9 7 25 9 7 25 9 10 10 10 13 14 35 15 17 18 19 18 17 19 18 33 30 22 30 27 34 29 27 34 27 34 29
4 13 10 29 8 27 10 29 27 27 27 10 29 27 8 8 10 29 27 27 27 10 29 27 27 27 10 29 27 27 27 10 29 27 27 27 10 29 27 27 27 10 29 27 27 27 10 29 27 27 27 10 29 27 27 27 10 29 27 27 27 10 29 27 27 27 10 29 27 27 27 10 29 27 27 27 10 29 27 27
4 44 27 6 54 29 11 31 31 32 54 19 35 17 37 22 54 54 54 54 53 53 53 53 53 53 53 53 53 53 53 53 53 53
4 5 13 8 12 6 24 26 22 28 25 29 32 33 31 31 34 27 27 28 33 34 30 31 33 34 27 27 30 32 33 31 34 27 27 28 33 34 30 31 33 34 27 27 30 32 33 31 34 27 27 28 33 34 30 31 33 34 27 27 30 32 33 31 34 27 27 28 33 34 30 31 33 34 27 27 30 32 33 31
4 24 6 46 6 18 17 33 19 33 21 42 32 22 21 38 34 32 34 21 30 32 22 21 30 32 34 21 30 32 34 21 30 32 34 21 30 32 34 21 30 32 34 21 30 32 34 21 30 32 34 21 30 32 34 21 30 32 34 21 30 32 34 21 30 32 34 21 30 32 34 21 30 32 34 21 30 32 34 21
4 17 9 10 9 10 6 11 11 13 14 15 16 21 19 19 20 20 7 8 6 7 15 10 9 15 10 9 15 10 6 7 10 9 7 15 9 11 13 14 15 16 21 19 20 7
4 6 6 6 20 20 18 16 21 21 22 23 23 23 24 26 26 31 30 32 32 32 31 30 32 32 32 7 32 30 11 32 32 32
4 32 5 29 10 22 22 22 16 22 22 22 22 22 22 22 22 22 22 22 22 22 22 22 22 22 22 22 22 22 22 22 22 22 22 22 22 22 22 22 22 22 22 22 22 22 22 22 22 22 22 22 22 22 22 22 22 22 22 22 22 22 22 22 22 22 22 22 22 22 22 22 22 22 22 22 22 22 22 22
4 22 5 28 14 29 6 27 29 6 27 6 27 17 6 27 6 27 17 6 27 6 27 17 6 27 6 27 17 6 27 6 27 17 6 27 6 27 17 6 27 6 27 17 6 27 6 27 17 6 27 6 27 17 6 27 6 27 17 6 27 6 27 17 6 27 6 27 17 6 27 6 27 17 6 27 6 27 17 14
4 14 12 45 14 23 22 23 22 23 22 23 22 23 22 23 22 23 22 23 22 23 22 23 22 23 22 23 22 23 22 23 22 23 22 23 22 23 22 23 22 23 22 23 22 23 22 23 22 23 22 23 22 23 22 23 22 23 22 23 22 23 22 23 22 23 22 23 22 23 22 23 22 23 22 23 22 23 22 23
4 52 10 24 30 25 31 27 25 29 23 36 23 23 34 23 23 34 23 23 34 23 23 34 23 23 34 23 23 34 23 23 34 23 23 34 23 23 34 23 23 34 23 23 34 23 23 34 23 23 34 23 23 34 23 23 34 23 23 34 23 23 34 23 23 34 23 23 34 23 23 34 23 23 34 23 23 34 23 23
4 5 6 7 19 20 17 19 17 6 17 7 19 17 6 17 7 19 17 19 17 6 17 7 19 17 19 17 6 17 7 19 17 19 17 6 17 7 19 17 19 17 6 17 7 19 17 19 17 6 17 7 19 17 19 17 6 17 7 19 17 19 17 6 17 7 19 17 19 17 6 17 7 19 17 19 17 6 17 18
4 5 5 36 9 11 12 12 18 19 21 24 25 27 16 26 32 33 34 14 36 33 34 38 38 38 38 33 34 38 38 38 33 34
4 8 10 11 10 11 10 11 10 11 10 11 10 11 10 11 10 11 10 11 10 11 10 11 10 11 10 11 10 11 10 11 10 11 10 11 10 11 10 11 10 11 10 11 10 11 10 11 10 11 10 11 10 11 10 11 10 11 10 11 10 11 10 11 10 11 10 11 10 11 10 11 10 11 10 11 10 11 10 11
4 5 5 19 20 20 21 22 13 21 22 24 26 26 27 28 28 32 32 37 37 41 38 39 11 39 11 14 16 16 16 16 18 15 16 18 15 16 11 15 7 16 12 20 21 22 24 26 26 27 28 28 32 32 37 37 41 41 39 11
4 5 13 8 10 15 19 16 20 18 28 27 29 27 23 25 32 32 39 40 35 42 40 41 40 41 21 40 41 43 40 42 40 41
4 20 16 6 21 8 12 12 11 9 15 15 15 6 15 18 6 15 21 22 18 18 18 18 21 22 18 18 18 18 18 21 16 21
4 12 11 12 6 10 8 15 14 16 17 18 22 20 21 24 6 24 22 9 24 11 6 17 22 13 23 7 11 11 6 17 22 9
4 16 8 11 29 31 29 31 29 31 29 31 29 31 29 31 29 31 29 31 29 31 29 31 29 31 29 31 29 31 29 31 29 31 29 31 29 31 29 31 29 31 29 31 29 31 29 31 29 31 29 31 29 31 29 31 29 31 29 31 29 31 29 31 29 31 29 31 29 31 29 31 29 31 29 31 29 31 29 31
4 9 10 8 9 17 27 9 10 27 16 10 17 27 16 10 17 27 16 10 17 27 16 10 17 27 16 10 17 27 16 10 17 27 16 10 17 27 16 10 17 27 16 10 17 27 16 10 17 27 16 10 17 27 16 10 17 27 16 10 17 27 16 10 17 27 16 10 17 27 16 10 17 27 16 10 17 27 9 10
4 12 6 7 8 9 10 11 9 10 11 9 10 11 9 10 11 6 10 11 6 10 11 6 10 11 9 10 11 9 10 11 9 10 11 9 10 11 9 10 11 9 10 11 9 10 11 9 10 11 9 10 11 9 10 11 9 10 11 9 10 11 9 10 11 9 10 11 9 10 11 9 10 11 9 10 11 9 10 11
4 5 5 6 14 7 9 8 10 8 8 10 8 10 8 8 10 8 10 8 8 10 8 10 8 8 10 8 10 8 8 10 8 10 8 8 10 8 10 8 8 10 8 10 8 8 10 8 10 8 8 10 8 10 8 8 10 8 10 8 8 10 8 10 8 8 10 8 10 8 8 10 8 10 8 8 10 8 10 8
4 5 6 9 6 9 6 9 6 9 5 6 9 6 9 10 6 9 6 9 10 6 9 6 9 10 6 9 6 9 10 6 9 6 9 10 6 9 6 9 10 6 9 6 9 10 6 9 6 9 10 6 9 6 9 10 6 9 6 9 10 6 9 6 9 10 6 9 6 9 10 6 9 6 9 10 6 9 6 9
4 8 5 5 41 14 17 17 50 7 50 60 21 50 60 21 50 60 51 55 55 51 71 53 72 74 81 82 15 53 72 82 82 74 15 81 13 39 39 39 39 43 39 39 43 39 29 14 17 27 7 50 7 50 60 21 50 60 51 55 55 51 71 53 72 74 81 82 15 53 72 82 82 74 15 81 13 39 39 39
4 9 5 6 7 5 9 10 13 10 16 14 14 15 18 19 20 21 21 22 23 24 25 26 27 30 32 33 33 34 23 25 26 27 30 32 33
4 9 7 22 9 7 22 6 10 11 11 12 13 14 15 16 17 18 18 17 18 18 17 18 18 17 18 18 17 18 18 17 18 18 17 18 18 17 18 18 17 18 18 17 18 18 17 18 18 17 18 18 17 18 18 17 18 18 17 18 18 17 18 18 17 18 18 17 18 18 17 18 18 17 18 18 17 18 18 17
4 35 20 18 17 20 21 23 24 13 26 22 22 23 24 25 26 22 22 22 23 24 25 26 22 22 22 23 24 13 26 22 22 22 23 24 25 26 22 22 22 23 24 25 26 22 22 22 23 24 13 26 22 22 22 23 24 13 26 22 22 22 23 24 13 26 22 22 22 23 24 13 26 22 22 22 23 24 13 26
4 5 5 22 22 22 22 22 23 23 10 11 14 13 15 16 14 13 15 17 31 21 27 7 27 27 7 27 27 27 27 27 27 27
4 5 5 7 14 11 11 9 12 13 9 12 13 9 12 13 17 17 17 17 17 17 18 7 7 7 7 7 7 7 7 7 18 13
4 6 7 25 12 13 13 13 13 15 16 17 19 18 18 16 17 19 18 18 16 17 19 18 18 16 19 18 18 16 17 19 18 18 16 17 19 18 18 16 19 18 18 16 17 19 18 18 16 19 18 18 16 17 19 18 18 16 17 19 18 18 16 17 19 18 18 16 19 18 18 16 17 19 18 18 16 17 19 18
4 28 18 20 22 21 25 21 23 74 26 26 21 21 27 27 10 43 52 54 56 58 86 82 68 74 51 53 51 53 51 55 51 55
4 7 9 8 9 11 13 13 12 16 17 19 23 22 23 24 24 17 19 22 23 24 15 12 13 16 17 19 23 24 22 23 24 15 12 13 16 17 19 23 24 22 23 24 15 12 13 16 17 19 23 24 22 23 24 15 12 13 16 17 19 23 24 22 23 24 15 12 13 16 17 19 23 24 22 23 24 24 17 6
4 51 24 39 7 27 29 25 30 50 26 32 31 32 31 33 33 55 15 38 55 60 63 64 47 66 66 50 60 60 63 64 47 9
4 46 6 7 8 6 10 10 11 12 12 14 15 18 22 15 21 20 19 25 25 8 26 40 41 30 31 32 43 35 36 37 38 38
4 5 6 8 7 10 12 14 14 16 15 17 18 19 20 18 16 19 20 11 16 16 19 20 18 16 19 20 18 16 19 20 18 16 19 20 18 16 19 20 18 16 19 20 18 16 19 20 18 16 19 20 18 16 19 20 18 16 19 20 18 16 19 20 18 16 19 20 18 16 19 20 18 16 19 20 18 16 19 20
4 18 8 7 8 11 10 12 11 13 11 10 11 12 13 9 16 16 17 17 17 24 9 10 12 11 12 13 9 16 17 17 16 17 17 24 9 10 12 11 12 13 11 10 11 12 13 9 16 17 17 16 17 17 24 9 10 12 11 12 13 11 10 11 12 13 9 16 17 17 16 17 17 24 9 10 12 11 12 13
4 24 10 13 5 14 15 16 17 17 19 17 16 15 18 17 17 19 17 16 18 18 18 17 19 17 16 15 18 17 17 19 17 16 18 18 18 17 19 17 16 15 18 17 17 19 17 16 18 18 18 17 19 17 16 15 18 17 17 19 17 16 18 18 18 17 19 17 16 15 18 17 17 19 17 16 18 17 18 18
4 7 7 6 6 8 9 10 11 13 14 13 15 16 16 16 21 21 21 21 21 21 21 21 21 21 21 21 21 21 21 21 21 21
4 22 22 45 45 18 79 18 79 18 79 18 79 18 79 18 79 18 79 18 79 18 79 18 79 18 79 18 79 18 79 18 79 18 79 18 79 18 79 18 79 18 79 18 79 18 79 18 79 18 79 18 79 18 79 18 79 18 79 18 79 18 79 18 79 18 79 18 79 18 79 18 79 18 79 18 79 18 79 22
4 14 5 6 9 6 5 6 9 6 9 10 11 12 12 13 12 10 11 16 19 24 24 22 23 26 25 30 29 28 30 29 28 11
4 5 8 7 7 7 20 9 11 11 9 12 14 10 10 10 9 12 10 14 10 10 10 9 12 10 14 10 10 10 9 12 10 14 10 10 10 9 12 10 14 10 10 10 9 12 10 14 10 10 10 9 12 10 14 10 10 10 9 12 10 14 10 10 10 9 12 10 14 10 10 10 9 12 10 14 10 10 10 9
4 65 44 63 7 47 13 33 14 33 32 19 37 77 37 77 80 63 70 63 63 63 63 63 63 63 63 63 63 63 63 63 13 33 14 33 32 19 37 77 37 77 80 63 70 63 63 63 63 63 63 63 63 63 63 63 63 63 13 33 14 33 32 19 37 77 37 77 80 63 70 63 63 63 63 63 63 63 63 63
4 48 48 28 94 126 18 98 10 20 20 21 16 16 21 71 25 25 34 25 30 25 28 33 26 116 9 130 99 92 31 63 74 94 126 94 126 94 126 94 126 126 94 126 82 10 11 21 20 16 21 16 25 25 25 34 25 30 25 117 28 33 63 9 130 99 13
4 5 5 12 7 8 19 11 20 15 23 18 14 16 18 18 23 26 26 32 33 32 33 31 33 32 33 31 33 32 33 31 32 33
