4 21 1 4 21 7 7 10 11 10 14 15 12 15 16 18 20 19 20 21 21 7 24 7 24 16 23 24 7 24 7 24 24 16
4 7 8 8 21 16 17 16 17 18 21 20 10 19 21 17 16 18 17 19 21 21 22 10 19 24 27 27 27 14 19 14 19 14
4 21 29 29 29 29 19 28 29 29 29 29 29 29 19 28 29 29 29 29 29 29 29 29 19 21 29 29 29 29 29 29 29 29
4 6 6 16 12 13 14 15 7 18 19 20 22 23 24 25 20 10 31 30 33 34 31 32 33 34 31 32 10 33 34 31 32 10
4 5 5 6 7 10 11 12 13 14 15 17 15 17 22 20 15 17 22 20 15 17 10 11 13 6 8 9 10 11 12 13 14 15 17 15 17 22 20 15 17 22 20 15 17 10 11 13 6 8 9 10 11 12 13 14 15 17 15 17 22 20 15 17 22 20 15 17 10 11 13 6 8 9 10 11 12 13 14 15
4 6 8 9 11 12 13 14 10 11 12 13 14 10 11 12 13 14 10 11 12 13 14 10 11 12 13 14 10 11 12 13 14 36 15 16 17 18 12 13 14
4 7 6 7 7 7 7 7 7 7 7 7 7 7 11 10 10 10 13 18 14 20 19 26 20 22 6 20 26 6 7 6 7 7
4 18 6 24 21 20 22 23 21 20 19 22 30 46 35 42 45 17 39 40 40 46 45 47 40 40 39 48 46 38 47 40 40 39
4 11 7 8 9 10 6 15 16 18 19 15 16 18 19 25 26 27 28 29 30 31 32 33 34 36 35 36 37 36 35 36 37 36
4 16 7 6 7 9 21 9 21 9 21 9 21 9 18 9 7 9 7 22 21 9 21 9 21 9 18 22 7 9 7 9 21 9
4 29 59 20 29 45 41 47 42 46 44 43 44 42 46 48 50 48 50 59 20 59 20 29 7 38 7 62 11 50 48 50 54 24
4 13 8 10 13 10 9 6 8 10 13 6 9 8 10 9 9 16 6 8 10 13 9 16 19 6 9 19 16 6 9 8 10 9 19
4 14 16 11 7 12 9 10 11 8 8 5 8 6 17 13 19 9 10 11 8 8 14 8 6 17 13 19 9 10 11 8 8 9 8 6 17 13 19 9 10 11 8 8 5 8 6 17 13 19 9 10 11 8 8 5 8 6 17 13 19 9 10 11 8 8 5 8 6 17 13 19 9 10 11 8 8 5 8 16
4 6 7 8 13 10 9 13 11 10 37 11 10 37 11 10 37 11 10 18 18 19 20 26 25 27 31 30 31 36 15 32 12 7
4 9 7 8 9 10 11 12 13 14 15 16 17 18 19 20 17 18 19 20 23 24 25 26 27 28 29 30 31 32 33 35 34 35
4 5 12 75 13 25 23 24 26 34 24 39 32 42 24 43 8 48 7 63 59 85 48 74 89 94 95 93 54 70 85 54 93 87 89 94 79 77 87 89 75 94 79 77 87 89 75 94 79 77 87 89 75 94 79 77 87 89 75 94 79 77 87 89 75 94 79 77 87 89 75 94 79 77 87 89 75 94 79 93
4 8 28 6 9 10 12 16 14 15 20 21 22 23 24 25 23 25 42 28 29 42 44 45 46 42 44 45 46 42 44 45 46 42 44 45 46 42 44 45 46 42 44 45 46 42 44 45 46 42 44 45 46 42 44 45 41 42 44 40 41 42 44 40 46 42 44 45 46 42 44 45 46 42 44 45 46 42 44 45
4 6 9 6 5 5 6 7 9 12 5 6 7 9 5 6 7 9 5 6 7 9 5 6 7 9 5 6 7 9 5 5 9 8 8 7 9
4 17 37 18 14 15 16 37 18 19 20 21 22 23 24 17 19 20 23 22 23 24 17 26 27 28 30 31 39 11 36 11 37 18 14 39 24 37
4 5 8 10 9 10 10 10 10 10 5 8 10 10 10 5 10 10 5 10 10 10 10 10 5 8 10 10 5 10 10 10 10 10
4 8 7 10 9 10 7 10 9 10 11 12 13 23 17 18 19 20 22 24 25 9 26 9 22 26 9 22 23 24 26 9 22 26
4 41 9 37 9 10 12 13 13 12 13 19 23 32 21 22 23 32 25 36 27 40 27 40 32 20 36 20 36 20 38 33 36 31
4 16 15 14 15 16 17 5 17 8 9 10 11 7 22 7 11 28 29 19 29 18 21 27 28 29 19 29 18 21 27 28 29 19 29
4 21 6 9 14 8 14 17 15 11 18 12 12 18 12 11 18 12 19 19 19 18 19 19 22 9 9 21 6 9 14 9 21 22
4 7 8 9 12 14 15 11 9 13 13 13 13 6 7 22 5 8 9 12 14 15 11 9 13 13 13 13 6 17 22 23 17 21
4 32 38 6 7 38 11 10 13 9 12 15 19 18 17 16 15 19 18 24 16 15 26 22 29 26 34 38 35 23 7 38 29 26 28 33
4 32 33 23 7 7 7 7 7 7 7 7 7 7 7 7 7 7 7 7 7 7 7 7 7 7 7 7 7 7 7 7 7 7 7 7 7 7 7 7 7 7 7 7 7 7 7 7 7 7 7 7 7 7 7 7 7 7 7 7 7 7 7 7 7 7 7 7 7 7 7 7 7 7 7 7 7 7 7 7
4 6 23 8 28 8 25 8 12 13 14 15 16 17 13 18 19 19 26 25 26 23 7 23 7 26 23 7 25 26 23 7 7 26
4 11 9 29 5 12 13 14 15 18 19 20 22 21 23 21 28 29 26 7 26 7 26 14 35 36 37 30 31 32 33 35 36 37
4 21 9 14 9 14 12 8 6 16 9 16 12 8 6 14 9 14 12 8 6 14 9 16 12 8 6 14 9 14 12 8 6 14 9 14 12 8 6 14 9 14 12 8 6 14 9 14 12 8 6 14 9 16 12 8 6 14 9 14 12 8 6 14 9 14 12 8 6 14 9 14 12 8 6 14 9 16 12 8
4 8 27 31 27 19 8 18 16 17 18 24 19 16 18 19 16 18 24 24 8 16 17 18 24 24 8 8 16 18 24 19 8 8 16 17 18 24 24 8 8 16 18 24 19 8 8 16 17 18 19 24 8 8 16 18 24 19 8 8 16 17 18 24 19 8 8 16 18 19 19 8 8 16 17 18 24 24 8 8
4 5 6 5 8 9 18 19 20 21 22 25 26 27 31 32 30 28 14 30 31 14 30 31 14 30 31 14 30 31 14 30 31 14 30 28
4 9 6 7 19 9 10 12 13 9 15 16 17 18 19 20 20 20 15 16 17 18 8 20 20 20 15 16 17 18 19 20 20 20
4 10 7 8 9 6 11 12 13 15 14 16 17 18 19 20 21 22 24 25 26 27 28 29 35 30 31 32 33 34 35 36 37 37
4 10 7 13 9 15 12 7 13 9 15 28 12 7 5 9 15 28 12 30 13 25 16 17 17 18 19 20 21 22 19 21 30 24 25 32 31 28 12 23 26 28 31 29 28 12 23 26 28 12 23 26 28 31 23 28 30 30 28 31 30 28 29 23
4 29 29 6 19 9 10 11 12 13 14 15 16 17 14 15 16 17 22 29 29 29 29 25 26 23 7 25 26 23 19 26 7 24
4 20 13 9 48 64 6 30 32 27 28 28 30 32 29 33 32 34 38 37 38 40 41 42 39 40 41 42 39 40 41 42 39 40 41 42 39 40 41 42 39 40 41 42 39 40 41 42 39 40 41 42 39 40 41 42 39 40 41 42 39 40 41 42 39 40 41 42 39 40 41 42 39 40 41 42 39 40 41 42
4 17 13 2 4 17 7 22 21 7 20 21 21 17 22 21 17 22 21 7 20 21 7 20 21 7 20 21 17 20 21 17 20 21
4 15 9 16 8 9 7 11 10 10 12 13 14 12 13 14 11 12 13 14 12 11 13 12 11 13 12 13 14 12 11 10 9 7 7 12 13 14 11 10 12 13 14 12 11 13 12 13 14 12 11 14 10 9 7 7 7 7 20 7 22 20
4 11 45 5 15 32 35 38 37 33 39 36 37 34 40 42 56 28 56 47 56 47 56 16 56 52 56 47 56 14 56 47 56 47
4 15 13 28 26 23 17 18 19 20 25 21 22 24 24 25 29 36 35 36 37 44 45 47 50 11 47 33 50 11 51 41 44 48 11
4 11 6 8 8 9 9 11 14 15 17 18 16 13 19 20 21 6 8 8 9 9 21 12 20 21 6 8 8 9 9 9 21 20 21 6
4 5 5 9 18 12 11 13 15 18 14 15 19 8 17 6 7 8 17 6 7 8 17 6 7 8 17 6 7 8 17 6 7 8
4 55 47 26 57 7 59 55 47 57 7 59 55 47 49 7 59 55 47 49 7 59 47 49 7 59 47 49 7 59 47 49 7 59 47 49 7 59 47 57 7 59 47 49 7 59 47 49 7 59 47 49 7 59 47 57 7 59 47 49 7 59 47 49 7 59 47 57 7 59 47 49 7 59 47 49 7 59 47 57
4 5 11 12 13 10 6 17 18 19 20 22 23 24 25 26 27 28 29 30 32 35 34 40 37 38 8 8 37 38 8 8 37 40 36
4 5 5 5 5 5 5 5 5 5 5 5 5 5 5 5 5 5 5 5 5 5 5 5 5 5 5 5 5 5 5 5 5 5 5 5 5 5 5 5 5 5 5 5 5 5 5 5 5 5 5 5 5 5 5 5 5 5 5 5 5 5 5 5 5 5 5 5 5 5 5 5 5 5 5 5 5 5 5
4 15 15 35 36 26 42 84 81 48 30 32 16 17 18 19 19 25 33 25 35 22 24 25 33 49 41 56 57 58 59 80 55 56 57 58 59 60 61 64 67 68 69 71 59 60 61 64 67 68 69 71 72 61 64 67 68 69 71 77 72 77 64 77 78 80 12
4 24 16 13 15 14 16 16 32 6 33 24 7 33 28 7 30 31 32 6 33 28 7 33 28 28 32 33 28 28 33 32 6 33 7
4 15 16 10 8 12 14 9 11 14 9 10 16 12 15 8 14 9 10 16 12 15 14 11 9 10 16 8 12 15 14 9 11 16 21 22 24
4 5 6 7 5 20 10 11 12 13 15 16 17 26 15 16 17 27 28 21 22 23 24 20 20 8 9 24 20 8 9 24 20 8 9 24 20 8 9 24 20 8 9 24 9 5 9 24 20 8 9 24 20 8 9 24 20 8 9 24 20 5 20 24 25 8 9 24 20 8 9 24 20 8 13 11 12 16 15 17
4 7 9 6 5 9 6 5 11 12 13 14 15 18 16 17 18 9 6 5 9 6 5 11 12 13 14 15 16 17 18 9 9 6
4 11 6 14 32 14 40 11 17 20 18 19 17 20 22 23 22 23 22 23 20 21 22 23 22 23 20 21 22 23 22 23 20 21 22 23 22 23 20 21 22 23 22 23 20 21 22 23 22 23 20 21 22 23 22 23 20 21 22 23 22 23 20 21 22 23 22 23 20 21 22 23 22 23 20 21 22 23 22 23
4 37 30 10 20 12 22 14 24 35 30 31 28 29 30 31 37 35 36 37 40 41 43 44 43 44 16 31 40 42 40 41 43 44
4 5 14 5 8 9 10 11 12 14 17 18 19 20 16 18 19 20 17 18 19 20 14 17 19 20 18 19 20 14 17 18 19 20
4 64 59 32 71 72 44 14 22 100 72 40 46 46 47 49 48 46 47 49 51 80 31 37 89 82 18 18 24 76 66 78 76 60 82 83
4 17 11 11 7 8 7 9 10 11 12 16 15 17 16 17 11 11 17 16 15 17 16 17 11 11 17 16 15 17 16 17 11 11
4 17 27 5 30 33 32 33 62 42 74 38 61 63 43 46 40 53 46 61 63 53 38 61 55 63 43 46 53 54 61 41 53 46 61 43 46 62 42 74 38 61 63 53 46 61 43 46 62 42 74 38 61 63 53 46 61 43 46 62 42 74 38 61 63 53 46 61 43 46 62 42 74 38 61 63 53 46 61 53
4 8 6 9 27 12 13 14 15 16 9 18 20 19 21 22 21 22 27 7 7 30 31 30 31 31 23 16 18 20 19 22 21 22 10 7 7 30 31
4 5 5 10 11 12 13 14 16 18 15 17 10 14 12 8 6 21 19 21 22 15 24 6 24 20 26 34 25 35 31 32 29 30 35 36 37 38 39 43 35 42
4 16 7 8 9 10 24 14 15 6 17 13 14 15 6 17 13 21 20 21 8 24 11 25 7 24 11 25 7 21 22 24 11 25
4 8 10 7 6 13 21 17 18 19 23 24 25 31 30 29 33 5 31 32 9 30 16 7 5 31 7 31 32 9 33 5 31 32
4 31 25 52 36 42 42 40 41 45 46 43 44 51 49 8 51 52 53 54 46 52 53 54 46 52 53 54 46 52 53 54 46 52 53 54
4 6 9 10 11 14 15 16 22 23 24 27 21 22 23 24 25 27 44 45 46 30 42 34 32 37 33 43 44 45 46 24 29 30 32 37 42 43 44 45 46
4 9 20 7 9 10 9 10 9 19 7 9 19 9 10 9 19 16 20 9 19 7 9 20 7 9 9 10 9 19 9 10 16 20 9 10 7 9 20 7 9 9 10 9 10 9 10 16 20 9 10 7 9 20 7 9 9 20 9 10 9 10 9 19 16 20 9 10 7 9 20 7 9 9 10 9 10 9 10 16
4 15 7 6 9 10 11 12 13 14 6 16 12 13 14 6 16 12 20 19 21 22 10 10 10 10 14 20 19 21 8 10 10 10
4 26 26 26 26 26 26 26 26 26 26 26 26 26 26 26 26 26 26 26 26 26 26 36 21 21 11 26 26 26 26 26 26 26 26 26 36 21 21 11 26 26 26 26 26 36 21
4 19 8 9 10 11 12 15 18 21 15 18 21 18 18 18 18 18 20 15 18 12 20 15 18 18 18 18 18 18 18 20 18 20
4 14 8 9 10 12 13 14 16 17 18 19 20 21 22 9 18 10 12 13 14 16 17 18 19 20 21 22 9 18 10 12 13 14 16 17 18 19 20 21 22 9 18 10 12 13 14 16 17 18 19 20 21 22 9 18 10 12 13 14 16 17 18 19 20 21 22 9 18 10 12 13 14 16 17 18 19 20 21 22
4 6 20 8 17 18 29 30 31 32 33 34 35 39 40 38 39 40 45 47 41 44 46 31 32 29 30 31 32 34 35 39 40 38 39 40 45 47 41 44 45 31
4 18 8 7 8 9 10 11 12 13 14 15 16 17 18 15 16 17 18 15 16 17 18 15 16 17 18 15 16 17 18 15 16 17 18 15 16 17 18 15 16 17 18 15 16 17 18 15 16 17 18 15 16 17 18 15 16 17 18 15 16 17 18 15 16 17 18 15 16 17 18 15 16 17 18 15 16 17 18 15
4 6 5 8 10 12 21 13 14 15 19 23 20 20 17 5 27 28 29 30 31 26 26 27 28 29 30 29 5 28 29 30 26 31
4 14 20 20 19 20 20 20 14 11 19 20 20 20 14 15 15 18 19 20 19 20 19 20 20 20 14 11 18 19 20 20 20 14
4 26 7 8 11 13 14 12 13 15 18 17 18 19 16 16 16 18 17 19 16 16 18 17 19 16 16 18 17 18 19 16 16 26 8 26
4 10 11 45 29 6 11 45 59 9 48 51 53 28 54 24 23 50 62 63 19 50 34 65 66 75 74 74 66 65 63 64 66 75 74 74 66 65 33 64 19 50 48 21 23 28 54 24 62 35 65 63 19 50 34 66 75 74 10 90 6 77 78 79 95 46 98 95 59 8
4 6 32 9 10 13 8 11 10 34 10 13 8 11 10 34 10 13 8 11 10 34 10 13 8 11 10 34 10 13 8 11 10 34 10 13 8 11 10 34 10 13 8 11 10 34 10 13 8 11 10 34 10 13 8 11 10 34 10 13 8 11 10 34 10 13 8 11 10 34 10 13 8 11 10 34 10 13 8 11
4 9 7 8 6 12 13 23 23 22 24 26 28 24 28 34 45 42 43 44 40 41 43 44 40 11 40 8 40 43 44 40 8 40
4 6 19 6 8 8 11 10 12 13 14 16 16 17 6 19 19 18 19 21 22 23 25 25 17 22 25 23 25 25 17 22 23 25
4 9 7 23 10 11 13 12 13 14 22 16 9 19 19 19 19 6 6 21 23 23 19 19 19 6 6 9 23 19 19 19 6 6 9
4 20 21 9 7 20 7 7 7 10 7 7 7 7 12 12 17 13 15 14 15 16 17 13 15 14 15 16 17 13 15 14 15 16 17 13 15 14 15 16 17 13 15 14 15 16 17 13 15 14 15 16 17 13 15 14 15 16 17 13 15 14 15 16 17 13 15 14 15 16 17 13 15 14 15 16 17 13 15 14
4 34 6 35 6 21 35 11 12 13 15 24 16 18 17 20 19 26 31 26 7 8 38 39 25 21 37 38 39 35 37 38 39 21 28
4 16 20 30 25 29 27 33 38 39 32 40 41 42 43 45 46 45 16 50 44 20 50 44 46 49 44 20 44 42 43 45 45 16 50 44 46 20
4 5 6 10 5 7 10 5 11 9 11 15 17 18 21 21 24 23 24 22 23 24 22 23 24 22 23 24 22 23 24 22 23 24
4 7 8 9 10 13 14 15 21 22 23 26 20 21 22 23 24 26 39 44 45 27 37 29 30 31 37 33 31 36 37 38 43 44 45
4 8 7 8 13 10 11 5 13 10 11 8 13 7 12 16 14 15 18 17 18 16 22 21 24 23 13 24 23 13 24 22 22 23
4 9 10 11 7 26 14 10 11 7 30 14 10 11 7 26 14 15 16 17 18 17 18 14 21 21 23 13 8 14 13 26 23 12 31 14
4 7 7 9 11 12 8 14 54 51 38 49 50 51 25 39 51 6 56 57 37 29 46 51 25 49 57 37 29 46 51 25 49 57 37 55 46 51 25 49 57 37 55 46 51 25 49 57 37 29 46 51 25 49 57 37 55 46 51 25 49 57 37 55 46 51 25 49 57 37 55 46 51 25 49 57 37 55 46 51
4 25 23 45 22 23 17 45 10 11 45 25 27 32 26 28 29 31 34 35 36 37 38 38 32 25 17 16 7 45 16 7 45 25 27 32 26 28 29 31 34 35 36 37 38 38 32 25 17 16 7 45 16 7 45 25 27 32 26 28 29 31 34 35 36 37 38 38 32 25 17 16 23 45 22 11 45 25 27 32
4 23 5 24 20 21 22 6 24 25 26 29 28 27 30 5 34 35 36 8 17 10 21 22 18 24 25 26 29 28 27 30 5 34 35 36 8
4 23 7 6 7 11 24 8 7 11 24 17 18 15 13 14 16 17 18 16 14 20 19 10 22 25 23 26 27 8 27 8 21 25
4 9 7 8 20 10 10 11 13 14 35 15 17 16 19 18 19 18 17 19 18 22 30 36 26 32 36 34 25 8 26 27 36 31 27 34
4 14 15 16 15 20 19 24 10 29 26 26 12 12 8 17 8 24 10 29 26 26 12 12 27 17 8 17 14 14 14 16 15 20 21 24 10 29
4 12 36 38 32 12 19 34 15 24 16 36 35 38 23 22 23 16 19 18 37 22 35 24 54 22 23 16 19 18 37 22 35 24 54 22 23 16 19 18 37 22 35 24 54 22 23 16 19 23 37 36 35 24 54 22 23 16 19 18 37 22 35 24 54 17 18 16 19 18 37 22 35 24 54 22 23 16 19 23
4 5 6 15 8 14 7 16 8 20 13 24 26 23 27 28 25 29 32 31 33 34 38 37 45 46 47 46 47 14 43 42 43 44 38 46 47 48 41 42 43 44 38 46 47 48 49
4 6 6 25 25 26 51 28 55 13 6 15 34 18 16 17 19 33 21 22 38 29 34 21 22 22 8 26 32 26 32 28 13 62 13 62 63
4 6 15 9 10 11 12 13 14 15 16 19 7 20 10 21 20 10 7 20 15 10 7 20 15 10 7 20 15 10 7 20 15 10
4 15 6 27 12 13 14 15 16 20 18 14 15 16 17 21 22 23 24 26 31 30 32 32 30 32 32 8 27 30 32 32 26 32
4 34 29 10 10 22 38 20 48 29 22 22 38 37 14 14 19 29 16 38 37 38 20 48 29 22 22 38 37 14 14 21 48 29 22 16 38 37 14 14 48 29 22 16
4 18 5 27 13 14 8 28 6 27 17 14 8 28 6 27 28 14 9 17 14 8 28 6 9 28 14 9 17 14 8 28 14 8 28 14 9 17 14 8 28 14 8 28 14 9 17 14 8 28 14 8 28 14 9 17 6 9 28 14 8 28 14 9 17 14 8 28 14 8 28 14 9 17 14 8 28 14 8 28
4 14 12 31 14 22 25 23 24 14 25 22 23 24 14 25 22 23 17 24 14 25 22 23 17 24 14 25 22 23 17 24 14 25 22 23 17 24 14 25 22 23 17 24 14 25 22 23 17 24 14 25 22 23 17 24 14 25 22 23 17 24 14 25 22 23 17 24 14 25 22 23 17 24 14 25 22 23 17 24
4 52 24 9 30 27 25 31 21 22 29 36 37 34 35 37 15 52 15 52 55 39 40 52 41 42 5 55 5 52 40 41 7 42 7
4 18 6 19 18 18 9 11 13 12 13 12 10 13 12 13 19 20 21 17 14 17 14 17 7 17 6 21 19 17 14 17 18 17
4 8 8 9 10 11 12 25 8 18 19 22 21 24 25 27 30 16 32 33 34 14 38 8 10 11 12 25 17 30 14 32 33 34 14 38 8 10 11 12 25 27 30
4 11 10 9 11 9 9 9 22 22 22 7 11 11 11 22 22 7 11 11 11 22 22 7 11 11 11 22 22 7 11 11 11 22 22 7 11 11 11 22 22 7 11 11 11 22 22 7 11 11 11 22 22 7 11 11 11 22 22 7 11 11 11 22 22 7 11 11 11 22 22 7 11 11 11 22 22 7 11 11
4 17 5 19 13 21 22 31 24 24 25 26 27 28 29 30 32 33 34 35 36 37 38 39 8 40 9 39 22 40 41 39 40 8
4 13 8 12 7 14 15 19 17 17 16 18 20 28 29 27 26 25 33 32 38 39 40 41 42 35 44 42 40 41 40 41 42 12
4 21 22 16 21 22 8 7 11 9 10 10 15 15 6 18 18 18 18 18 16 18 18 18 18 18 18 18 18 18 18 16 21 22
4 12 6 23 7 5 6 11 5 14 15 16 17 18 22 20 21 24 10 24 7 24 6 11 6 23 24 7 24 6 24 22 23 24
4 11 21 18 19 20 21 18 19 22 31 30 31 29 31 10 29 31 10 17 15 11 15 11 17 15 17 11 17 7 31 11 28 29
4 16 17 18 11 12 20 21 22 35 33 34 36 38 34 47 38 34 47 41 45 44 35 43 44 45 42 39 48 42 43 40 41 45 44 14
4 9 7 8 6 10 13 14 15 16 17 18 22 23 19 20 19 25 26 27 28 29 30 31 32 33 34 35 36 37 27 28 29 30 31 32 33 34 35 36 37
4 6 14 6 14 8 9 10 8 9 10 10 9 8 10 10 9 8 10 14 12 13 12 13 6 14 6 10 9 8 10 9 10 8 12 13 6
4 6 17 9 5 9 6 9 5 9 6 20 14 15 17 9 5 20 20 20 20 20 20 20 20 20 20 20 20 20 20 20 20 20
4 47 5 6 7 45 46 25 39 26 60 42 43 49 50 51 52 53 54 55 71 83 74 70 71 83 73 78 73 81 77 74 73 81 77 72 73
4 5 6 7 5 9 11 12 13 14 15 16 17 18 19 20 19 20 21 22 23 24 25 26 27 28 29 31 32 33 34 23 24 25 26 29 31 32 33 34 23 24 25 26 29 31 32 33 34 23 24 25 26 29 31 32 33 34 23 24 25 26 29 31 32 33 34 23 24 25 26 29 31 32 33 34 23 24 25 26
4 6 7 8 6 10 11 12 13 14 15 16 17 18 17 18 21 8 21 24 26 30 27 8 29 30 27 29 28 24 26 30 27 29
4 9 11 12 25 14 16 16 17 18 17 21 21 23 22 24 13 26 5 33 32 28 28 31 28 5 32 28 28 31 28 5 32 28 28 31
4 22 22 9 22 9 7 10 13 14 15 16 17 14 15 16 17 31 7 27 27 31 7 27 27 31 7 27 27 27 27 31 7 9
4 7 7 11 11 9 10 12 13 12 13 9 12 13 7 17 17 17 13 7 7 7 7 9 12 13 7 9 12 13 7 17 17 13
4 6 7 45 11 12 13 13 15 16 17 19 18 6 7 10 12 13 15 16 17 19 18 19 55 27 25 25 25 47 45 53 47 45 55 41
4 11 6 35 8 11 22 21 57 11 22 21 59 33 23 92 26 27 27 32 33 26 27 27 17 44 74 57 51 52 57 96 72 82 76 88 44 51 52 55 58 78 82 68 72 92 51 52 53 70 61 51 52 55 58 82 68 70 92 51 52 53 58 53 82 61 51
4 9 9 28 5 6 28 5 6 28 5 15 13 12 16 17 18 19 20 23 24 25 22 7 6 28 5 6 28 5 6 28 5 15 13 12 16 17 18 19 20 23 24 25 22 17 26 21 24 17 26 21 24
4 14 7 24 29 26 32 28 27 29 30 50 28 32 31 33 33 7 29 50 32 59 33 24 29 9 33 55 28 17 27 29 50 32 31 33 33 7 29 9 50 32 26 31 33 33 12 29 9 50 32 26 31 33 33 16 29 9 50 32 26 31 33 33 12 29 9 50 32 26 31 33 33 12 29 9 50 32 26 31
4 6 7 8 9 10 11 12 13 14 15 16 18 22 23 19 20 19 25 25 39 40 29 30 31 32 43 34 35 36 45 38 39 40 41 42 33 44 35 36 45 38 39 28 29 42 33 44 35 36 45 38 39 40 41 42 33 34 35 36 45 38 39 40 41 42 33 34 35 36 45 38 39 40 41 42 33 44 35 36
4 6 30 8 10 12 14 15 11 16 19 18 17 20 18 20 19 20 18 17 20 11 20 18 17 19 20 18 17 20 19 18 17 20 11 20 18 17 19 20 18 17 20 19 18 17 20 11 20 18 17 19 20 18 17 20 19 18 17 20 11 20 18 17 19 20 18 17 20 19 18 17 20 11 20 18 17 19 20 18
4 8 21 6 9 10 11 12 13 15 24 17 16 17 16 17 21 17 15 9 10 11 12 13 24 22 17 15 16 17 16 17 22 23 24 25 26 27
4 5 21 10 11 13 14 15 16 17 18 19 17 19 5 13 30 27 32 33 13 9 27 32 21 30 31 32 33 8 9 40 41 42
4 6 19 8 19 8 11 9 14 13 10 14 13 15 16 16 21 6 21 6 21 6 19 8 11 9 14 13 10 14 13 15 16 16 21 6 21
4 22 18 81 21 6 24 79 22 25 26 72 64 37 32 42 75 73 76 46 53 10 75 80 67 74 70 70 82 82 76 73 65 74 70
4 9 6 7 8 9 10 11 12 13 10 11 12 13 17 24 16 17 18 19 20 21 22 23 24 25 26 30 29 28 29 27 29 28 29
4 6 7 6 11 9 12 9 14 10 10 14 21 20 20 19 6 20 19 6 20 19 16 20 19 16 20 19 16 20 19 6 20 19
4 71 53 33 60 36 37 35 55 56 35 20 19 57 20 56 57 37 19 57 20 56 57 37 80 68 74 70 41 45 68 74 70 11 71 68 9 76 26 41 45 68 74 70 41 45 68 74 64 80 68 74 70 43 78 80 62 76 26 41 45 70 71 78 68 74 70 41 41 45 78
4 82 30 82 34 117 117 87 124 94 13 30 67 117 18 58 58 10 11 21 20 85 25 99 54 126 94 33 81 102 8 93 90 74 92 74 92 126 99 7 130 29
4 5 6 32 12 7 8 20 19 11 10 23 17 14 23 18 16 18 18 23 31 32 33 31 32 33 31 32 33 31 32 33 31 30
