4 21 7 24 16 23 23 24 7 24 7 24 16 23 24 7 7 24 7 24 16 23 23 24 7 24 7 24 7 24 16 23 24 16
4 7 12 21 16 17 18 16 17 19 21 21 24 27 27 10 19 7 8 8 8 7 12 12 14 19 12 12 12 12 12 12 12 24
4 21 29 29 29 14 15 22 17 17 22 22 17 23 22 17 23 22 17 23 22 17 23 22 17 23 22 17 23 22 17 23 22 17 23 22 17 23 22 17 23 22 17 23 22 17 23 22 17 23 22 17 23 22 17 23 22 17 23 22 17 23 22 17 23 22 17 23 22 17 23 22 17 23 22 17 23 22 17 23
4 13 16 12 6 14 15 7 18 19 22 23 10 25 24 25 20 10 31 32 33 34 24 25 20 33 34 24 25 23 30 28 10 33 34
4 5 5 6 7 8 9 10 11 12 13 14 15 24 17 22 15 17 22 26 27 28 29 30 29 30 24 27 16 28 16 30 25 27
4 6 8 36 34 15 12 13 14 10 11 12 13 14 10 15 16 17 18 12 25 20 21 22 23 22 24 25 19 31 38 34 37 38
4 7 6 7 7 16 15 13 11 10 10 10 13 18 14 19 20 26 22 23 26 19 22 6 20 26 19 22 23 26 19 22 6 23 26 19 22 6 23 26 19 22 6 23 26 19 22 6 23 26 19 22 6 23 26 19 22 6 23 26 19 22 6 23 26 19 22 6 23 26 19 22 6 23 26 19 22 6 20 26
4 14 6 24 20 21 22 23 19 20 19 22 42 46 35 32 46 38 46 47 40 40 39 40 46 39 48 6 21 22 20 19 22 23 21 20 19 22 19 19 18 19 14 24 46 14 20 22 19 21 23 19 20 19 22 30 46 35 12 46 38 46 47 40
4 6 7 8 9 10 6 15 16 18 19 14 15 16 18 19 24 25 26 27 28 29 30 31 32 33 34 35 36 37 36 35 12 36
4 6 7 9 21 7 6 13 7 9 7 6 7 9 7 10 12 13 14 21 16 18 9 18 9 7 9 21 7 9 18 9 7 9
4 29 38 45 44 43 47 42 46 47 44 43 46 48 50 48 50 59 33 20 29 8 38 54 25 12 20 29 7 38 54 47 29 7
4 8 6 13 10 8 10 13 10 13 8 10 13 6 8 10 13 6 8 10 13 6 8 10 13 10 13 8 10 13 6 8 10 13 6 8 10 13 6 8 10 13 10 13 8 10 13 6 8 10 13 6 8 10 13 6 8 10 13 10 13 8 10 13 6 8 10 13 6 8 10 13 6 8 10 13 6 8 10 13
4 14 11 7 12 14 10 11 8 8 5 15 11 17 18 19 17 27 19 20 27 19 20 18 22 5 26 10 11 8 20 27 19 17 27 19 20 27 19 20 27 19 20 18 22 5 26 10 11 8 20 27 19 17 27 19 20 27 19 20 18 19 20 18 22 5 26 10 11 8 20 18 19 17 18 19 20 18 19 20
4 32 17 7 8 9 10 11 13 15 10 18 19 20 26 25 24 27 31 30 31 34 15 34 12 14 7 36 15 11 9 11 13 32
4 9 7 8 6 10 11 12 13 14 15 16 17 18 19 20 17 18 22 23 24 25 26 27 28 29 30 31 32 33 34 35 24 34
4 5 85 75 13 25 23 24 26 41 24 39 32 42 44 43 38 24 39 43 42 44 43 38 56 53 7 48 20 85 48 74 89 90 78 95 93 87 89 51 78 77 71 87 74 89 90 94 77 73 89 75 78 77 87 89
4 8 7 8 9 10 12 16 14 15 20 21 22 24 23 22 23 25 22 10 42 36 28 29 7 33 34 35 37 38 39 44 40 46 42 44 45 46
4 6 9 6 5 6 9 9 5 6 9 12 5 9 5 9 8 6 9 5 9 8 6 9 6 11 12 9 6 9 6 9 6 9
4 17 37 7 27 35 13 15 7 36 9 38 14 15 16 5 18 24 20 21 22 23 24 5 19 20 21 22 21 24 17 19 20 21 22 21 24 5 19 20 21 22 21 24 17 19 20 21 22 21 24 5 19 20 21 22 21 24 17 19 20 21 22 21 24 17 19 20 21 22 21 24 17 19 20 21 22 21 24 17
4 5 8 8 10 9 10 10 5 9 10 10 5 8 10 5 10 9 10 10 5 8 11 12 5 8 10 5 8 11 12 5 8 10
4 6 7 8 9 10 11 12 13 23 24 17 18 19 20 22 23 24 25 26 9 26 22 26 9 22 26 9 22 26 24 25 26 9
4 33 6 27 9 10 13 12 13 12 13 33 33 32 21 19 23 32 25 26 27 28 32 36 20 38 33 36 20 38 31 40 32 31
4 5 15 14 15 5 17 10 9 8 11 7 22 7 8 11 28 29 19 18 21 27 28 29 19 27 15 5 17 15 5 17 27 28 29
4 9 6 9 8 14 17 15 15 11 18 12 18 19 19 19 13 18 12 14 9 19 13 18 12 14 9 15 11 18 12 19 19 15 18 12 11 18 12 19 19 19 15 18 12 11 18 12 19 19 19 15 18 12 11 18 12 19 19 19 15 18 12 11 18 12 19 19 19 15 18 12 11 18 12 19 19 19 15 18
4 7 8 9 14 12 15 11 14 22 13 13 15 19 22 23 6 17 6 17 6 17 6 17 22 11 23 13 14 22 19 19 23 21
4 6 30 7 30 11 10 12 13 9 15 19 18 19 16 17 18 19 14 16 15 19 18 24 16 15 28 24 26 22 29 25 35 30
4 36 26 27 7 7 7 7 8 7 7 7 7 7 7 7 7 7 7 7 7 7 7 7 7 7 7 7 7 7 7 7 7 7 7 7 7 7 7 7 7 7 7 7 7 7 7 7 7 7 7 7 7 7 7 7 7 7 7 7 7 7 7 7 7 7 7 7 7 7 7 7 7 7 7 7 7 7 7 7
4 6 6 23 8 7 8 23 8 25 8 12 13 14 15 17 16 17 18 19 19 8 7 26 23 7 26 23 7 26 23 7 26 23
4 5 5 9 29 5 12 13 14 15 16 17 18 34 20 21 22 23 21 23 26 25 26 7 30 31 32 33 19 35 36 37 35 36 37
4 21 9 16 9 6 9 6 12 8 6 16 12 14 12 8 6 14 12 14 19 23 27 19 27 23 6 6 6 23 6 14 6 14
4 27 31 27 24 8 27 19 25 8 7 24 26 30 29 31 27 24 29 31 27 19 26 31 27 19 26 31 27 24 26 31 27 19 29 31 27 24 29 31 27 24 29 31 27 24 29 31 27 24 29 31 27 19 29 31 27 24 29 31 27 24 29 31 27 24 29 31 27 24 29 31 27 24 29 31 27 24 26 31
4 5 6 5 8 9 29 27 28 8 14 30 31 17 18 19 20 21 22 25 26 24 25 26 27 31 29 15 31 32 21 30 31 14
4 8 6 7 8 9 10 12 13 9 15 16 17 18 19 20 20 19 9 10 20 15 16 17 18 19 20 20 19 9 10 20 15 16
4 10 7 8 9 6 11 12 13 14 15 16 17 18 19 20 21 22 24 25 26 27 28 29 35 30 31 32 33 34 35 36 37 37
4 10 25 7 5 9 6 12 7 5 12 13 32 16 17 17 18 19 20 21 22 23 24 15 25 11 27 29 28 12 26 28 29 23
4 29 29 29 29 29 6 29 21 22 23 26 7 24 26 23 23 19 26 23 19 26 23 26 19 26 19 26 19 24 26 23 27 24
4 20 13 48 64 6 30 32 28 27 28 29 33 34 38 37 38 39 40 41 42 41 42 58 50 53 69 77 68 64 74 51 73 74 16 53 77 51 73 58
4 17 7 20 21 21 17 22 21 7 21 7 20 21 7 20 21 7 20 21 17 20 21 7 20 21 17 20 21 17 20 21 17 20
4 15 9 16 15 9 7 11 10 12 13 14 11 10 12 13 14 11 10 14 12 13 14 11 10 9 7 7 12 13 14 11 10 9 7 7 12 13 14 11 10 10 14 12 13 14 11 10 12 13 14 11 10 14 12 13 14 11 10 9 7 7 12 13 14 11 10 9 7 7 12 13 14 11 10 10 14 12 13 14
4 18 45 49 32 39 35 36 37 33 34 40 38 42 42 52 50 16 56 47 29 12 14 56 52 29 56 25 47 56 16 56 25 56
4 15 8 44 23 43 18 19 20 25 21 23 22 24 43 49 25 29 10 11 51 15 41 44 45 47 48 50 11 51 47 42 48 11 51
4 11 6 8 9 9 11 14 15 15 17 14 16 11 12 19 20 21 12 20 21 6 8 8 9 9 21 12 20 21 6 8 9 9
4 5 17 7 8 6 7 8 9 19 9 18 7 8 18 14 15 11 13 12 15 17 14 15 6 19 8 17 19 9 19 9 18 17
4 50 70 75 21 23 22 24 37 39 28 41 42 43 44 29 43 55 47 47 49 7 59 55 47 49 70 59 55 62 49 7 59 67 73 75
4 5 6 15 12 13 10 11 17 18 19 20 18 19 22 23 24 25 26 27 28 29 30 31 32 33 36 37 38 39 38 37 8 40
4 5 5 5 5 5 5 5 5 5 5 5 5 5 5 5 5 5 5 5 5 5 5 5 5 5 5 5 5 5 5 5 5 5 5 5 5 5 5 5 5 5 5 5 5 5 5 5 5 5 5 5 5 5 5 5 5 5 5 5 5 5 5 5 5 5 5 5 5 5 5 5 5 5 5 5 5 5 5 5
4 6 6 7 8 39 27 11 81 29 30 32 16 17 18 19 20 21 22 23 24 25 39 70 52 12 29 30 31 23 25 33 34 49 48 71 40 36 39 38 39 40 27 45 46 29 14 52 30 55 56 57 58 62 60 61 62 63 64 65 69 27 71 58 62 60 61 64 67 27 74
4 28 16 13 10 11 14 15 16 16 24 13 15 14 16 24 16 7 13 15 16 16 24 13 14 15 16 16 24 13 14 15 16 16 24 13 15 14 16 24 16 7 13 15 16 16 24 13 14 15 16 16 24 13 14 15 16 16 24 13 15 14 16 24 16 7 13 15 16 16 24 13 14 15 16 16 24 13 14 15
4 15 16 10 8 12 9 11 14 15 12 20 20 21 22 24 16 21 22 24 16 20 24 21 22 12 8 9 14 11 10 16 21 22 24
4 5 6 19 8 20 10 11 12 13 14 15 16 17 26 27 28 21 22 23 24 20 24 9 24 20 24 9 24 9 24 9 24 9 24 20 24 20 24 9 24 9 24 25 8 13 11 12 26 10 11 16 14 15 16 17 26 27 28 21 22 23 24 9 24 20 24 20 24 9 24 9 24 20 24 9 24 9 24 20
4 10 9 6 5 9 6 5 11 12 13 14 15 18 16 17 18 18 9 6 5 9 14 6 5 9 14 15 18 5 9 6 5 9
4 9 26 11 36 6 18 17 19 18 17 20 22 23 22 23 11 9 26 11 36 6 36 11 18 17 20 19 22 23 22 23 20 22 26 37 26 29 30 32 40
4 42 17 44 19 11 21 13 23 24 35 30 30 35 41 43 44 35 36 37 39 40 41 42 43 44 44 43 44 39 41 42 43 44
4 7 6 5 8 9 10 11 12 6 7 8 9 10 11 12 14 5 6 5 8 9 10 11 12 14 5 6 5 8 9 10 11 12 14 5 6 5 8 9 10 11 12 14 5 6 5 8 9 10 11 12 14 5 6 5 8 9 10 11 12 14 5 6 5 8 9 10 11 12 14 5 6 5 8 9 10 11 12 14
4 60 59 20 44 104 108 9 14 26 20 44 26 71 72 46 46 47 49 48 41 74 82 83 78 83 17 60 59 32 51 76 66 78
4 17 11 11 7 8 7 9 10 11 12 15 16 15 17 16 10 11 11 12 16 15 17 16 10 11 11 12 15 17 16 10 11 11
4 13 21 102 76 5 30 31 32 33 37 54 61 63 53 60 40 27 81 49 100 93 106 107 8 12 94 93 106 107 76 82 94 91
4 6 6 26 8 9 10 11 12 13 14 15 16 9 18 20 19 21 22 10 8 7 8 9 10 11 12 13 14 15 16 9 18 20 19 21 22 27 8 7 8 9 27 11 12 13 15 16 9 18 20 19 21 22 10 8 26 8 9 10 11 12 13 15 16 14 23 18 20 19 22 21 22 27 8 26 8 7 21 22
4 5 5 10 11 12 13 14 15 16 17 18 19 25 21 8 23 24 25 26 27 28 33 34 31 32 29 30 35 36 37 38 39 41 42
4 23 7 22 6 10 11 12 13 14 15 16 17 25 12 13 14 15 9 17 25 12 13 14 15 9 17 25 12 13 14 15 23 17 25 12 13 14 15 16 17 25 12 13 14 15 16 17 25 12 13 14 15 16 17 25 12 13 14 15 16 17 25 12 13 14 15 16 17 25 12 13 14 15 9 17 25 12 13 14
4 5 6 7 6 12 15 7 14 18 17 13 21 23 22 24 25 27 7 32 30 29 33 8 31 32 32 30 29 7 31 32 9 33
4 31 31 40 41 42 40 45 46 43 44 51 49 51 50 36 54 46 52 53 54 54 22 54 54 46 52 53 54 54 46 52 53 54
4 10 7 6 9 13 11 18 13 14 15 16 22 23 24 27 21 22 23 24 25 26 27 28 33 30 31 32 38 34 35 36 37 42 43 44 41 42 43 44 45 46
4 9 20 7 9 10 7 9 19 7 9 19 16 20 9 10 7 9 7 9 10 16 20 9 19 7 9 7 9 10 16 20 9 19 7 9 7 9 10 16 20 9 19 7 9 7 9 10 16 20 9 19 7 9 7 9 10 16 20 9 10 7 9 7 9 10 16 20 9 19 7 9 7 9 10 16 20 9 10 7
4 15 7 6 9 10 11 12 13 14 15 16 6 16 12 19 20 21 8 10 11 12 13 14 15 16 12 19 20 21 6 10 11 12 13 14 15 16 12 19 20 21 6
4 26 26 26 26 26 10 11 13 9 14 15 17 18 19 20 21 21 18 19 11 19 13 9 14 15 17 18 21 20 21 21 26 26 26 28 36 30 7 33
4 19 8 9 10 11 12 18 7 15 18 21 15 18 21 20 15 18 20 15 18 21 18 21 18 18 20 15 18 21 18 18 18 21
4 24 14 16 17 15 8 9 10 12 13 14 16 17 18 19 20 21 22 9 10 17 18 19 20 21 22 17 18 19 20 21 22 9 10 12 11 13 14 16 17 18 19 20 21 22 9 10 17 18 19 20 21 22 17 18 19 20 21 22 9 10 12 11 13 14 16 17 18 19 20 21 22 9 10 17 18 19 20 21
4 6 20 8 17 10 7 36 13 14 15 25 17 27 28 29 30 31 32 33 34 35 36 6 29 30 31 32 33 34 35 36 6 29 30 31 32 33 34 35 36 6 29 30 31 32 33 34 35 36 6 29 30 31 32 33 34 35 36 6 29 30 31 32 33 34 35 36 6 29 30 31 32 33 34 35 36 6 29 30
4 18 8 7 6 9 10 11 12 13 14 15 16 17 18 15 16 17 18 15 16 11 12 13 14 15 16 17 18 15 16 17 18 15 16 17 18 15 16 17 18 15 16 17 18 15 16 17 18 15 16 17 18 15 16 17 18 15 16 17 18 15 16 17 18 15 16 17 18 15 16 17 18 15 16 17 18 15 16 17
4 6 5 8 11 12 21 13 14 15 16 19 17 20 9 9 7 26 29 27 28 7 29 27 28 29 30 31 26 27 28 29 30 31
4 14 20 20 19 20 20 14 20 20 20 14 11 19 20 14 20 20 14 20 18 19 20 20 19 20 19 20 14 20 20 14 20 18
4 26 7 8 25 11 13 12 15 18 17 18 19 16 16 16 17 18 19 16 16 17 18 19 16 16 17 18 19 16 16 17 18 19 16 16 17 18 19 16 16 17 18 19 16 16 17 18 19 16 16 17 18 19 16 16 17 18 19 16 16 17 18 19 16 16 17 18 19 16 16 17 18 19 16 16 17 18 19 16
4 40 41 45 29 31 21 53 48 54 28 54 51 48 28 29 35 65 33 64 49 50 29 31 54 51 48 28 29 31 54 21 18 58 29 54 62 35 65 63 64 19 50 29 65 35 65 63 64 49 50 29 31 54 51 48 58 59 31 54 21 48 58 29 54 62 35 65 63 64 19 50 29 65 35 65 63 64 19 50
4 6 32 9 10 13 8 9 10 34 10 21 18 11 20 28 27 22 23 20 25 24 22 23 25 27 29 30 6 13 34 9 34 9
4 6 36 13 9 37 8 19 20 18 22 23 24 25 26 28 24 28 34 19 45 42 43 44 40 41 40 43 44 41 40 41 44 43 44 41
4 6 7 8 9 10 11 12 13 14 16 8 17 6 19 12 13 14 16 8 17 18 19 12 13 14 16 8 17 18 19 18 19 21 22 23 25
4 9 7 23 22 23 7 23 7 23 7 23 7 23 7 23 7 23 13 10 11 13 12 14 22 23 16 18 6 23 19 18 6 23
4 7 6 9 20 9 20 19 7 7 7 12 12 17 13 15 14 15 16 17 18 6 7 10 6 19 10 10 7 10 7 10 19 7
4 34 6 28 21 11 13 16 12 15 29 16 18 17 20 35 19 26 21 37 36 39 21 37 36 38 39 21 7 28 38 39 21 28
4 23 44 42 16 23 23 50 41 42 16 23 50 45 46 16 50 42 43 40 41 42 43 40 41 42 43 16 50 45 46 16 50 42
4 5 6 10 8 18 11 9 10 15 17 18 11 9 10 21 21 24 23 22 23 24 22 7 10 23 24 22 10 23 24 22 10 23
4 12 6 5 8 12 10 11 9 13 14 15 21 22 23 26 20 21 22 23 24 25 26 27 37 29 30 31 41 33 34 35 36 37 38 39 40 37 38 43 44 45
4 8 13 7 8 13 10 11 5 13 14 15 16 17 18 15 17 18 22 7 20 20 24 23 6 10 24 19 23 13 10 24 7 24
4 12 6 10 11 8 14 15 16 17 18 17 18 14 15 16 17 18 14 15 16 17 18 17 18 14 15 16 17 18 14 15 16 17 18 17 18 14 15 16 17 18 14 15 16 17 18 17 18 14 15 16 17 18 14 15 16 17 18 17 18 14 15 16 17 18 14 15 16 17 18 17 18 14 15 16 17 18 14 21
4 7 7 9 8 10 11 14 12 15 36 58 34 60 22 51 48 49 43 37 22 46 61 62 63 64 64 56 57 37 29 46 61 62 63 64
4 6 11 45 16 17 12 25 27 32 25 26 28 27 31 35 28 36 37 38 32 38 12 16 17 45 10 17 45 25 27 32 7 30 28 26 29 31 34 35 36 37 38 32 38 17 45 10 17 45 10 17 12 25 27 32 25 26 28 27 31 35 28 36 37 38 32 38 12 22 17 45 10 17 45 25 27 32 7 30
4 5 18 9 37 10 21 9 17 14 20 21 22 23 24 25 26 29 28 29 30 23 18 25 26 29 28 27 30 5 21 35 36 8
4 23 7 11 6 8 7 11 24 17 18 16 13 14 19 10 22 25 23 26 27 8 8 27 21 8 22 23 26 27 27 20 21 25
4 9 7 25 6 10 10 11 13 14 35 15 17 16 19 18 19 17 18 19 25 22 30 34 31 27 36 31 27 36 31 27 31 27
4 12 29 27 8 10 27 14 14 16 15 20 19 14 24 10 29 26 12 8 17 17 29 17 29 14 14 17 29 24 29 12 29 16 14 14 20 21 24 10 29
4 54 36 35 24 32 54 36 35 24 18 34 22 21 38 54 23 34 19 37 35 22 18 34 23 35 22 23 34 19 23 35 22 18 34 23 35 22 23 34 19 23 35 22 18 34 23 35 22 23 34 19 23 35 22 18 34 23 35 22 23 34 19 23 21 22 18 34 23 35 22 23 34 19 23 35 22 18 34 23
4 5 6 7 17 14 19 20 13 22 24 25 26 23 27 28 30 32 33 31 34 30 32 33 31 34 16 30 32 33 31 34 16 30 32 33 31 34 16 30 32 33 31 34 16 30 32 33 31 34 16 30 32 33 31 34 16 30 32 33 31 34 16 30 32 33 31 34 16 30 32 33 31 34 16 30 32 33 31 34
4 6 6 8 26 10 53 12 57 6 15 34 16 18 16 17 19 33 21 38 29 22 22 34 32 32 22 21 6 15 34 32 18 17 19 33 21 38 29 22 22 34 32 32 22 21 6 15 34 32 18 17 19 33 21 38 29 22 22 34 32 32 22 21 6 15 34 32 18 17 19 33 21 38 29 22 22 34 32 32
4 9 15 6 8 7 12 13 14 15 16 10 19 20 15 10 21 20 10 7 20 15 10 7 20 15 8 7 20 15 8 7 20 15
4 18 5 19 20 12 13 14 15 16 17 18 19 20 21 22 23 24 26 24 29 30 31 32 8 30 32 8 7 33 29 5 32 8
4 19 22 20 10 19 16 19 8 15 48 29 16 19 16 19 20 16 19 8 15 14 29 16 19 16 19 16 19 20 16 19 20 16 19 33 15 14 29 16 19 16 19 16 19 20 16 19 20 16 19 8 15 14 29 16 19 16 19 16 19 20 16 19 20 16 19 8 15 14 29 22 19 16 19 16 19 20 16 19
4 18 17 6 27 28 6 27 16 6 8 28 6 27 16 6 8 28 6 27 17 14 8 28 6 27 17 14 8 28 6 27 17 14 8 28 6 27 17 14 8 28 6 27 17 14 8 28 6 27 17 14 8 28 6 27 17 14 8 28 6 27 17 14 8 28 6 27 17 14 8 28 6 27 17 6 8 28 6 27
4 14 16 9 14 47 20 10 25 23 22 24 14 25 24 15 33 20 8 49 47 54 32 47 9 49 46 15 47 7 49 19 9 11
4 28 23 24 47 25 31 27 21 22 29 36 34 35 37 15 37 15 52 21 22 29 27 36 34 24 47 32 36 37 34 37 32 51 52 17 39 40 52 41 42
4 7 17 6 18 9 11 13 12 10 12 13 12 10 9 11 13 12 10 12 13 7 20 21 17 14 17 7 17 14 17 18 17 19
4 8 8 10 11 12 8 18 19 22 21 22 19 18 24 25 27 30 29 5 34 14 32 33 34 14 38 17 8 10 11 12 25 33
4 11 10 11 9 17 13 13 14 18 19 20 22 22 22 7 11 11 22 22 22 7 11 11 11 22 22 22 7 11 11 11 7 7
4 10 5 19 13 21 22 31 23 24 25 26 27 28 29 30 32 33 34 35 36 37 41 39 40 41 40 39 22 40 36 38 40 39 9
4 7 8 8 12 7 14 15 19 17 17 16 18 20 28 29 26 25 21 33 23 44 33 39 40 41 42 41 14 10 38 39 40 41 42 35 44
4 21 22 16 22 9 11 8 7 10 11 9 10 15 6 15 6 16 18 18 18 18 22 16 9 11 10 15 18 18 18 16 21 22
4 8 6 7 5 6 10 11 5 6 7 5 14 15 16 17 18 22 20 21 24 22 10 24 13 23 24 7 24 6 11 24 13 10
4 11 15 15 18 20 21 18 19 22 31 24 31 6 27 29 31 10 9 31 6 15 6 10 9 31 6 10 9 31 6 27 13 31
4 16 17 11 19 45 16 11 19 10 18 21 23 24 23 22 35 37 49 43 40 41 45 44 45 49 39 48 49 45 49 51 48 45 38
4 6 7 8 9 10 11 13 14 15 16 17 18 19 20 21 22 23 19 25 26 27 28 29 30 31 32 33 34 36 35 31 33 34
4 6 14 8 9 10 8 9 10 8 10 14 13 6 12 13 6 12 6 14 9 8 10 10 8 9 8 10 14 13 6 12 6 14
4 9 5 6 9 5 9 5 9 10 9 5 9 5 9 5 9 5 9 5 9 5 9 5 9 5 9 10 9 10 9 5 9 5 9 5 9 5 9 5 9 5 9 5 9 5 9 5 9 5 9 5 9 5 9 5 9 5 9 5 9 10 9 5 9 5 9 5 9 10 9 5 9 10 9 5 9 5 9 10
4 47 5 6 7 17 37 47 48 30 17 60 28 34 44 50 51 52 53 54 55 72 29 70 71 83 73 74 73 78 75 77 78 79
4 5 6 7 8 9 10 11 12 13 14 10 15 16 17 18 19 20 19 20 21 22 23 24 25 26 27 28 29 30 31 32 33 33
4 6 7 22 9 10 11 12 13 14 15 16 17 18 22 21 8 21 24 25 26 27 8 29 30 27 8 29 26 30 8 22 8 24
4 9 11 12 14 16 21 22 23 24 13 26 33 5 32 28 6 30 28 31 6 35 11 29 14 35 18 6 31 28 6 29 14 29
4 22 31 7 22 7 22 23 7 10 12 16 17 14 15 13 15 16 17 21 31 7 7 7 31 7 27 31 27 31 27 31 22 9
4 13 7 9 11 10 9 12 13 12 13 7 9 11 12 13 9 12 13 7 17 17 17 13 13 7 9 10 12 13 9 12 13 7 17 17 17 13 7
4 6 7 8 29 36 11 12 13 13 13 16 17 18 19 6 7 25 25 33 41 47 48 54 8 9 56 45 41 47 45 59 53 56 53
4 5 20 35 10 42 13 22 10 36 20 24 22 21 23 92 26 27 32 33 57 38 29 33 26 27 90 44 74 52 38 33 23 24 21 27 90 74 33 38 32 33 26 27 90 44 74 52 38 33 23 24 21 27 90 74 33 38 38 33 26 27 90 44 74 52 38 33 23 24 21 27 90 74 33 38 32 33 26 27
4 9 9 28 5 6 28 5 19 20 16 15 13 12 14 15 17 19 20 23 22 25 24 17 26 21 22 25 24 12 18 16 17 19 20 22 23 24 25 24 17 26 21 22 7 28 31 24
4 10 7 25 26 29 30 27 28 17 33 31 32 29 11 50 54 50 58 66 45 63 64 47 9 49 36 65 36 49 52 60 50 38
4 9 7 8 9 10 16 11 12 13 14 15 16 21 14 15 18 19 20 21 22 23 19 25 38 26 40 41 30 31 32 43 34 35 36 45 38
4 6 30 22 10 11 12 14 15 16 19 18 17 20 19 20 11 17 18 20 19 20 11 17 18 20 19 20 17 18 17 20 19 20 11 17 18 20 19 20 17 18 17 20 19 20 11 17 18 20 19 20 17 18 17 20 19 20 11 17 18 20 19 20 17 18 17 20 19 20 11 17 18 20 19 20 17 18 20 19
4 6 21 8 9 10 11 12 13 15 24 17 15 16 12 13 10 11 12 13 24 17 15 16 17 22 17 12 13 10 11 12 15 13 24 17 16 17 22 23 25 26 27
4 10 10 11 12 13 14 15 16 17 19 17 18 19 10 15 40 40 6 26 31 32 33 26 27 39 9 30 38 40 39 42 40 41 42
4 6 19 8 11 9 8 14 13 10 14 13 11 9 12 10 14 13 15 16 16 14 12 11 9 8 19 14 13 14 15 16 16 11 6 21 6
4 18 22 81 82 21 14 24 79 48 48 10 42 65 63 46 75 66 74 70 73 68 75 73 76 65 75 69 75 73 76 51 16 53 72
4 5 5 6 7 8 9 10 11 12 13 11 12 13 6 6 7 8 9 10 11 12 13 11 12 13 18 15 16 17 18 19 20 21 22 23 24 25 26 30 28 29 27
4 16 7 20 9 12 11 9 12 14 16 10 14 16 20 20 7 16 19 7 16 19 20 16 19 16 20 6 19 7 16 19 7 6
4 71 18 35 55 19 35 37 56 57 52 80 68 74 70 41 78 68 74 70 41 78 68 26 64 41 78 68 24 70 41 78 68 26 64
4 94 7 30 130 30 117 67 109 58 58 11 21 10 16 108 93 93 39 87 110 126 99 54 126 82 116 87 127 85 130 92 40 130 31 92 33 71 42
4 16 20 10 7 8 12 11 15 16 18 23 17 14 18 23 32 13 16 18 14 23 32 33 26 32 16 18 18 23 31 32 33 6 32 33
