4 144 146 321 5 84 327 5 262 195 196 282 260 259 82 260 259 82 130 330 162 160 153 154 7 310 16 181 116 69 120 175 159 20 219 129 142 130 112 128 144 160 154 154 7 310 16 169 172 174 15 231 233 234 235 236 237 238 87 15 251 179 190 111 192 193 194 139 87 103 147 61 15 231 232 233 234 235 237 187
4 39 37 36 10 25 28 16 28 26 16 28 16 28 41 40 41 40 78 58 51 78 58 100 106 100 97 98 100 19 56 57 56 22 11 44 75 44 6 11 44 92 98 98 100 48 40 41 40 78 58 51 78 58 100 106 100 97 98 100 97 106 97 98 106 97 109 110 110 112 114 86 36
4 6 7 20 20 47 47 47 8 47 65 41 41 22 54 65 16 21 48 65 35 36 41 44 44 48 46 47 47 8 47 37 65 41 41 37 53 64
4 5 87 54 34 134 141 129 19 82 24 25 26 27 28 29 19 33 134 134 129 34 134 141 129 133 81 49 54 51 52 53 60 61 62 10 112 121 65 128 114 121 123 128 127 34 93 92 91 25 26 29 28 29 10 70 107 108 109 122 123 114 124 34 93 71 93 72 56 57 58 10 121 66 106 122 113 114 114 69
4 66 60 126 5 128 142 7 8 9 10 11 12 13 14 15 6 17 17 19 66 67 39 11 43 44 45 46 47 48 49 50 51 52 53 54 55 56 68 58 59 60 61 91 92 93 94 93 96 97 98 99 100 101 102 103 104 105 64 57 66 67 68 66 67 60 10 145 44 44 38 24 114 64 65 66 67 68 139 41
4 6 29 9 29 30 31 13 14 15 16 17 32 33 34 35 36 37 38 55 56 57 58 54 59 42 43 44 45 72 40 74 48 48 49 41 51 52 55 56 57 58 54 41 42 43 44 45 72 73 74 75 76 52 23 63 61 65 88 83 68 67 68 89 70 71 72 73 74 75 76 23 18 42 43 44 45 84 48 48
4 6 54 45 23 30 22 16 63 12 13 12 13 39 40 27 13 23 28 16 23 16 16 16 16 10 16 9 10 16 12 13 12 13 15 28 40 27 20 28 45 42 22 18 28 13 41 30 22 41 39 43 22 43 22 41 28 13 47 59 31 48 8 59 60 50
4 9 126 190 53 43 21 34 35 36 37 190 39 37 39 157 44 17 16 17 18 86 78 20 21 34 35 36 37 39 37 39 157 130 118 120 126 127 23 147 148 62 28 29 37 123 11 10 121 49 140 41 56 81 56 152 153 151 155 135 136 137 137 86 172 171 11 124 49 114 146 147 148 62 28 29 37 44 123 11
4 7 8 9 45 10 70 6 70 15 17 18 19 20 21 22 23 24 24 25 26 27 28 29 30 31 10 34 35 36 74 38 39 40 41 42 43 46 26 27 28 29 30 31 10 34 35 36 11 38 39 40 41 42 43 46 26 27 28 29 30 31 45 34 35 36 11 38 39 40 41 42 43 46 26 27 28 29 30 31
4 9 8 11 18 59 41 44 60 52 53 34 31 40 32 34 20 40 41 44 43 44 60 52 53 55 52 14 55 58 14 41 14 33 17 17 16 24 17 20 17 44 49 43 49 24 55 46 41 51 52 53 53 34 11 24 57 34 41 44 49 52 53 53 34 11 24 63 64 66 67 68 69 15 71 83 83 74 75 77
4 5 70 7 32 9 10 30 11 14 33 15 27 14 46 27 23 91 41 93 92 93 91 41 49 51 52 63 64 60 74 67 69 68 71 73 72 65 68 74 55 59 60 64 60 73 72 71 55 68 74 63 64 93 92 38 76 82 88 88 80 82 80 87 38 17 76 38 82 76 28 29 76 82 80 86 29 38 82 89
4 14 7 88 9 10 11 12 13 6 21 16 17 18 19 50 15 52 23 24 25 26 27 28 29 30 81 85 33 35 36 73 38 39 96 33 120 77 79 66 67 66 69 70 71 38 73 74 74 76 77 78 79 80 81 87 83 84 61 86 87 29 105 91 119 112 84 90 92 95 96 119 120 121 100 101 102 103 104 105
4 5 6 7 121 5 11 16 83 84 85 86 87 88 89 90 91 93 94 95 96 97 98 99 100 101 22 83 84 85 86 87 88 89 90 91 92 93 94 95 96 97 98 99 100 101 22 83 84 85 86 87 88 89 90 91 92 93 94 95 96 97 98 99 100 101 22 83 84 85 86 87 88 89 90 91 92 93 94 95
4 6 167 187 9 11 12 13 131 18 19 20 21 22 23 24 25 26 27 28 29 30 31 32 33 34 35 36 37 38 39 106 107 108 32 33 34 41 76 43 44 45 46 47 49 52 136 200 198 192 144 158 133 144 14 149 150 40 140 149 150 122 133 109 158 133 160 164 161 8 167 176 8 53 58
4 7 8 9 20 11 55 13 14 15 17 70 10 24 13 23 21 25 26 27 28 29 30 31 32 33 34 35 36 37 38 39 40 41 112 43 44 45 46 47 48 49 50 51 52 53 61 55 56 57 58 59 60 54 62 63 65 69 67 64 71 86 80 74 75 76 77 78 79 73 81 82 83 84 85 86 104 88 89 86
4 6 97 11 12 13 77 15 79 57 179 130 131 38 39 40 41 42 42 30 31 32 152 34 35 36 37 38 39 40 41 42 42 30 31 32 152 34 35 29 36 37 38 39 40 41 42 42 30 31 32 152 34 35 29 36 37 38 39 40 41 42 42 30 31 32 152 34 110 29 36 37 38 39 40 41 42 42 30 31
4 63 6 62 142 9 10 69 12 13 14 16 54 19 23 12 22 20 24 25 26 27 28 29 30 31 32 33 34 35 36 37 38 39 40 139 42 43 44 45 46 47 48 49 50 51 52 59 18 55 68 55 73 74 75 76 77 78 72 80 81 82 83 84 65 86 88 95 71 100 98 99 100 101 102 103 104 111 86 107
4 5 6 5 20 21 26 9 9 26 34 9 26 32 33 17 33 9 29 33 17 33 32 33 17 33 26 34 9 9 26 33 17 33 32 33 17 33 9 26 34 9 9 30 33 17 33 17 33 9 26 34 9 8 30 33 33 17 33 28 29 33 17 33 32 33 17 33 26 34 9 8 33 17 33 9 32 33 17 33
4 6 7 8 75 67 73 76 14 15 27 17 17 79 20 19 20 51 22 23 77 25 26 27 28 27 30 31 32 81 19 20 21 22 23 77 25 26 27 28 27 30 31 32 81 38 59 58 61 39 55 47 20 53 49 55 52 61 59 58 8 61 64 79 8 69 77 78 12 80 81 41 83
4 30 7 57 92 7 25 46 57 112 65 25 46 57 112 65 80 81 68 83 84 85 86 87 88 90 91 77 100 80 81 68 83 84 85 86 87 88 90 91 77 100 80 81 82 83 84 85 86 87 88 16 28 95 17 13 93 94 95 86 40 97 98 99 103 101 78 116 113 33 105 116 33 107 109 108 110 114 121 120
4 271 6 11 7 285 9 6 42 113 114 126 7 195 151 197 83 62 82 63 65 75 73 73 71 53 71 123 71 123 71 123 71 123 71 253 71 123 71 123 71 123 71 123 71 123 71 123 71 123 71 123 71 123 71 123 71 123 71 123 71 123 71 123 71 123 71 123 71 123 71 123 71 123 71 123 71 123 71 123
4 6 7 8 9 34 36 12 13 14 15 16 17 24 19 20 20 17 16 13 17 52 53 13 42 17 16 13 17 52 60 13 42 15 16 17 24 19 20 20 57 22 23 24 44 54 68 7 9 9 10 36 37 38 39 40 41 42 17 52 44 33 14 15 16 17 24 19 62 62 30 32 10 33 36 37 13 40 41 42
4 5 162 241 8 143 120 12 13 47 48 16 17 19 18 19 104 21 22 23 24 24 132 26 26 120 29 30 11 173 43 61 203 112 38 39 40 41 42 43 44 12 46 47 48 61 61 51 52 44 61 56 57 58 59 60 35 61 61 64 65 61 53 54 69 70 71 72 73 64 75 76 77 78 79 80 81 31 83 84
4 6 28 8 9 10 11 12 14 17 28 34 10 11 12 15 17 28 38 30 55 36 38 53 57 62 25 40 14 15 17 28 25 34 40 12 9 35 36 51 45 44 45 18 18 41 28 45 8 53 57 55 57 57 55
4 6 7 8 92 26 18 19 20 21 22 87 84 23 22 87 28 29 70 68 74 68 69 43 44 56 13 30 29 74 70 68 39 14 15 26 18 19 20 21 22 87 84 23 22 87 28 29 70 68 74 68 45 43 44 55 35 85 87 84 88 56 11 12 13 14 15 18 19 20 21 22 87 84 23 22 87 28 29 74
4 63 6 101 14 63 107 34 39 41 40 39 108 81 83 80 82 83 55 55 52 60 61 62 63 60 107 59 58 57 61 107 54 107 56 68 52 22 98 97 97 70 98 80 82 83 44 35 40 70 98 97 107 26 33 34 132 125 42 63 107 49 50 113 109 17 52 22 69 94 93 91 71 76 84 89 90 93 94 92
4 6 8 6 8 10 12 8 6 25 26 27 28 19 15 8 19 34 10 10 15 19 25 26 27 22 8 19 34 10 25 26 27 28 8
4 10 8 13 12 13 15 14 27 13 15 13 14 13 44 13 81 26 20 72 42 44 13 51 61 53 53 53 56 39 72 9 64 62 63 64
4 6 7 175 9 10 11 12 13 14 15 16 17 18 19 20 21 22 23 24 25 26 27 28 29 30 130 32 49 165 35 36 38 39 48 41 24 25 26 27 28 29 30 130 32 49 165 35 36 73 39 48 41 24 25 26 27 28 29 30 130 32 49 165 35 36 38 39 48 41 24 25 26 27 28 29 30 130 32 49
4 5 9 56 7 45 44 46 49 51 52 54 57 60 54 31 73 74 21 80 38 66 67 65 69 98 97 99 81 28 27 38 56 8 31 80 73 67 90 90 88 88 88 91 67 67 90 67 91 67 84 67 83 67 75 98 97 99 101 102
4 6 138 136 144 67 6 136 126 8 67 153 136 155 69 64 34 129 32 36 41 94 87 89 110 14 15 99 17 37 104 113 137 99 127 133 45 143 145 148 148 140 148 94 140 143 74 138 146 72 145 74 67 75 33 83 61 74 66 12 146 145
4 7 8 9 156 11 12 13 14 166 44 19 20 21 22 23 25 26 27 28 68 31 32 33 34 35 36 37 32 5 5 41 42 71 72 142 74 75 77 78 79 179 79 184 90 84 82 83 23 85 154 87 88 168 90 91 92 93 95 96 97 98 99 100 101 102 103 104 105 106 96 188 100 178 96 123 103 122 123 124
4 5 104 105 21 84 15 16 35 19 31 85 56 57 58 29 63 64 32 144 145 138 145 107 120 45 50 12 102 103 51 105 107 107 108 12 116 43 109 107 112 35 107 103 38 108 53 109 107 117 84 123 121 120 118 124 21 108 123 125 53 115 124 125 73 124 125 119 125 142 9 117 74 55 56 57 130 131 132 134
4 6 7 8 9 17 24 13 14 16 10 18 19 20 59 22 10 24 25 26 27 28 29 30 31 32 33 34 12 37 18 19 20 59 22 10 24 25 26 27 28 29 30 31 32 33 34 12 37 18 19 20 59 22 10 24 25 26 27 28 29 30 31 32 33 34 12 37 18 19 20 59 22 10 12 25 26 27 28 29
4 126 30 102 6 7 9 6 114 7 9 6 115 116 46 47 46 42 20 99 121 71 66 79 59 15 102 126 29 132 28 102 32 30 36 115 83 23 83 115 49 54 52 53 50 51 52 53 54 102 102 117 37 102 79 112 113 114 115 117 117 118 119 120 102 62 80 131 132 28 70 29 15 30 36 115 83 23 126 29
4 6 122 9 17 14 20 47 143 16 50 15 16 32 108 88 52 14 22 58 141 33 35 21 22 58 27 25 26 27 60 61 62 63 64 65 13 47 36 37 42 43 44 45 46 47 33 37 42 43 44 45 46 47 33 37 42 43 44 45 46 47 33 37 42 43 44 45 46 47 33 37 42 43 44 45 46 38 33 141
4 151 6 149 146 10 21 55 28 93 92 93 70 69 68 65 67 66 80 22 106 80 79 78 112 20 21 44 28 90 122 95 89 129 88 98 55 93 92 93 92 7 55 95 96 122 151 42 24 28 42 7 40 42 7 21 28 24 28 25 132 88 79 78 31 15 16 112 44 159 160 33 27 42 53 9 40 42 7 40
4 6 115 144 9 6 124 125 124 77 79 68 83 74 73 75 60 88 90 91 89 60 93 90 91 89 60 119 111 101 111 101 111 101 119 111 119 111 119 118 96 111 119 111 119 111 26 38 39 67 28 29 30 31 32 14 23 25 44 45 15 45 49 52 15 45 46 57 130 62 65 60 61 62 65 99 79 68 93 90
4 6 25 7 57 42 31 37 44 24 31 29 12 12 22 31 20 36 31 8 58 58 8 42 49 52 42 36 37 12 29 43 54 42 43 57 32 29 58 47 48 22 12 59 34 7 22 31 49 56 52 53 54 53 49 58 54 49 42 54 37 32 29 12 29 22 17 32 29
4 29 30 5 7 26 9 10 11 12 13 14 15 16 17 18 18 20 21 22 24 99 8 31 32 31 32 28 58 29 57 58 99 100 134 63 64 59 67 68 70 135 134 138 20 21 22 24 99 8 28 32 27 19 14 13 14 15 16 17 18 31 20 21 22 24 99 44 31 32 31 32 57 139 29 105 109 107 112 106
4 6 159 8 45 46 48 48 103 72 14 38 37 36 38 20 125 35 36 37 38 22 39 119 175 176 46 48 48 76 50 78 53 23 55 56 55 58 59 60 61 62 63 66 40 153 68 99 106 78 53 54 24 56 24 58 59 60 61 62 63 66 89 153 68 99 106 78 53 54 24 56 24 58 59 60 61 62 63 66
4 5 6 14 8 15 16 17 18 19 20 21 22 23 24 25 26 27 28 29 30 31 37 33 34 35 36 37 32 39 40 41 42 13 46 45 44 47 51 49 50 51 52 53 48 55 56 57 60 51 60 62 63 64 65 66 18 68 69 70 71 72 73 75 74 76 77 78 81 81 79 82 35 84 85
4 5 6 92 8 9 10 11 12 13 14 6 16 17 18 19 18 21 22 23 40 25 26 27 28 29 30 31 32 33 34 35 36 37 38 39 24 6 42 43 44 45 46 47 48 49 6 51 52 53 54 55 56 57 6 5 59 60 87 62 63 64 65 46 47 48 49 6 25 52 53 54 55 56 57 6 5 59 60 87
4 165 58 15 9 41 131 131 126 34 7 8 146 88 86 17 171 38 25 135 56 88 88 47 9 181 90 105 43 72 138 138 41 41 41 126 30 41 41 126 30 41 41 133 165 120 145 34 133 120 86 83 40 41 41 133 120 85 42 30 23 120 140 31 142 60 11 53 63 64 41 49 74 55 40 41 41 41 107 165
4 88 6 7 8 9 38 10 12 20 21 22 23 24 25 26 27 28 29 30 31 32 33 34 35 36 10 39 40 41 42 53 101 55 56 57 58 60 17 42 42 58 95 41 42 35 34 35 53 100 55 56 57 58 60 17 42 35 34 89 53 50 55 56 57 58 60 17 42 42 58 95 41 42 35 34 35 53 50 55
4 9 23 64 9 12 13 25 8 17 54 66 20 19 18 27 56 28 18 27 26 34 33 25 19 20 36 40 44 20 19 33 32 36 40 44 34 35 36 25 56 27 22 20 19 33 32 36 40 44 34 35 20 25 56 27 22 20 19 33 32 36 40 44 34 20 45 32 36 40 44 34 35 20 25 56 56 61 62 62
4 100 6 7 8 12 46 11 12 13 14 15 16 46 111 19 20 21 78 23 24 25 26 27 28 7 30 31 112 33 34 35 36 37 5 39 5 41 61 43 44 46 5 47 48 49 17 51 52 46 54 58 56 57 55 59 58 8 62 63 64 17 17 67 68 69 70 78 72 73 74 75 5 54 17 79 93 82 83 84
4 6 12 8 27 88 80 103 6 27 88 100 101 46 27 88 19 9 103 44 87 85 71 84 56 106 59 18 7 18 48 49 49 96 66 120 119 17 115 46 101 22 55 63 14 16 13 21 101 22 17 25 20 16 13 16 14 102 12 102 102 12 102 12 102 12 61 56 106 59 18 7 18 49 48 49 96 66 120 119
4 6 112 82 116 63 48 66 48 90 80 36 80 90 80 36 47 48 24 65 45 46 41 8 129 40 11 89 104 17 80 36 80 41 24 65 45 46 41 32 129 40 11 89 104 17 80 36 80 41 24 65 45 46 41 8 129 40 11 89 104 17 80 36 80 41 24 65 45 46 41 14 129 40 11 89 104 17 80 36
4 5 244 7 204 9 11 12 13 14 15 193 118 18 53 20 55 22 130 25 24 28 29 30 31 136 113 114 115 116 210 43 88 89 90 91 247 96 94 95 93 97 100 97 98 103 103 104 105 106 102 138 72 110 111 112 113 114 115 116 210 38 119 120 210 210 152 92 181 154 87 94 95 93 97 100 97 98 103 103
4 5 6 7 8 9 10 11 12 13 14 15 32 33 18 35 36 37 38 39 41 42 43 44 45 46 47 46 49 6 51 6 52 53 54 55 56 69 71 74 9 73 72 75 76 81 69 35 73 70 44 45 46 47 69 49 6 9 83 84
4 59 6 95 11 9 10 11 12 13 14 15 124 17 18 19 20 21 22 23 65 25 26 89 28 120 30 33 32 31 34 35 36 37 38 39 40 41 42 43 44 45 46 47 48 49 50 51 52 53 54 55 56 57 57 67 59 60 61 59 85 64 65 66 59 68 69 71 72 67 74 81 7 84 85 94 87 88 89 90
4 6 59 97 10 11 12 18 14 16 17 18 19 20 16 22 12 25 26 28 29 47 32 62 34 35 37 38 51 40 41 35 43 44 45 50 47 35 41 35 11 10 18 19 20 16 22 8 77 78 32 60 81 33 28 101 47 98 26 28 29 31 32 33 34 35 37 38 94 40 41 43 44 45 50 47 8 19 20 17
4 6 7 8 9 143 12 13 14 15 16 17 18 19 20 21 22 23 24 27 28 29 30 31 32 33 34 35 36 37 110 39 40 41 42 43 44 45 46 47 64 49 7 115 51 126 112 54 55 56 57 58 113 60 61 62 63 48 66 143 69 148 9 142 72 73 74 124 78 79 81 82 83 85 51 87 88 89 90 91
4 32 6 12 19 20 22 23 24 25 26 27 28 29 30 33 32 31 34 9 36 16 46 47 48 43 44 45 46 47 48 16 6 26 27 19 20 21 22 23 24 9 27 42 34 46 47 48 16 6 47 48 43 44 45 46 47 48 16 46 47 48 43 44 45 46 47 48 16 6 26 27 19 20 21 22 23 24 9 27
4 6 29 8 6 33 8 37 40 35 10 37 35 35 35 9 20 24 17 22 23 22 23 16 23 16 23 19 23 22 6 45 12 8 6 20 8 6 17 8 40 37 35 35 17 28 22 18 22 23 20 6 45 12 8 6 17 28 22 35 10 36 10 36 45 15 44 48 46 47
4 6 7 92 103 10 11 12 13 14 15 16 17 18 19 20 21 22 23 24 25 54 27 104 120 30 31 32 29 34 35 36 37 38 40 41 49 43 44 45 46 47 48 49 50 51 42 65 58 59 60 61 62 63 68 56 66 61 68 56 66 34 35 36 37 38 40 41 28 43 44 45 46 47 48 49 50 51 52 65
4 6 68 8 9 10 11 12 13 14 67 16 17 18 23 20 21 22 24 25 9 27 28 63 30 31 32 33 34 35 36 37 38 39 40 41 43 8 34 19 24 20 25 9 27 28 29 30 31 32 33 45 35 36 37 38 39 40 41 43 44 45 90 91 47 48 49 50 51 52 53 54 55 56 7 58 59 60 60 61
4 65 59 5 125 7 8 9 10 11 12 13 81 15 16 6 17 17 25 26 27 28 31 30 125 32 33 34 6 35 36 19 37 123 64 39 40 41 42 43 44 45 46 47 48 49 50 51 52 53 54 55 64 57 58 59 60 61 80 126 99 103 114 100 101 102 103 63 56 65 66 56 136 40 41 42 43 44 45 46
4 6 7 53 9 7 11 12 13 14 15 16 17 18 19 7 22 23 24 25 26 7 28 29 7 31 7 33 7 39 37 37 8 42 43 48 8 41 20 30 39 20 51 48 37 54 55 56
4 6 79 11 56 15 28 59 42 43 44 45 46 100 100 46 49 50 66 68 66 59 58 64 34 35 60 64 34 35 15 22 28 59 37 115 80 72 95 44 45 46 47 29 39 32 45 46 47 44 45 46 47 44 45 46 100 48 49 31 32 33 34 35 22 22 28 77 15 92 59 51 100 19 72 95 96 97 43 44
4 9 8 12 21 52 23 23 21 26 28 58 60 59 23 33 36 30 35 77 33 36 51 49 51 100 50 27 25 27 26 28 58 59 21 21 30 52 49 17 71 78 81 19 60 60 59 23 33 36 30 35 77 20 36 51 49 51 100 17 71 74 20 36 29 81 27 50 73 23 50 73 71 21 52 59 100 58 60 78
4 6 7 16 10 11 12 13 14 58 16 22 18 19 44 21 22 16 24 25 26 27 28 29 30 31 32 33 34 35 36 37 38 40 41 8 43 44 45 46 47 48 46 50 51 52 53 54 55 46 58 59 60 61 62 63 64 69 66 68 8 69 70 72 73 74 16
4 5 102 108 59 39 57 58 52 13 59 12 91 87 86 79 33 21 32 28 82 52 53 57 58 57 58 125 108 8 18 9 122 38 21 50 58 52 13 28 20 39 59 12 91 98 86 79 33 21 32 28 96 52 53 57 58 57 58 125 108 8 18 9 122 38 21 50 58 52 13 28 20 39 59 94 73 96 83 32
4 6 7 53 9 7 11 12 13 14 15 16 17 18 19 7 22 23 24 25 26 7 28 29 7 31 7 33 7 41 45 45 38 50 43 22 53 45 52 53 41 20 30 42 51 22 22 54 55 56
4 111 6 105 61 176 38 39 48 85 159 109 174 40 56 57 53 13 18 98 13 145 143 174 46 93 46 39 90 120 46 93 46 39 38 131 13 139 120 93 46 39 38 39 48 21 174 40 189 77 86 53 54 60 62 86 62 111 9 25 101 102 16 102 101 104 13 94 95 97 94 152 26 155 156 125 54 43 9 179
4 10 11 14 14 24 94 5 94 48 49 40 50 51 52 53 54 12 56 57 58 59 60 61 62 12 64 65 66 66 69 47 48 49 50 51 52 53 54 12 56 57 58 59 60 61 62 12 64 65 66 66 69 47 48 49 50 51 52 53 54 12 56 57 58 59 60 61 62 12 64 65 66 66 69 47 48 49 50 51
4 5 39 39 7 104 16 15 17 31 32 31 32 31 32 20 26 27 81 86 90 87 88 89 90 82 92 82 15 65 64 84 23 83 84 84 23 81 87 88 59 62 27 92 70 66 68 63 62 71 84 23 83 84 59 85 84 23 83 84 59 85 86 90 87 88 89 90 82 92 67 62 74 64 72 78 21 24 28 29
4 6 7 9 93 11 13 14 15 16 17 18 19 20 21 22 23 24 25 26 27 27 10 30 31 32 33 34 27 36 37 38 39 40 41 42 43 44 45 46 47 48 49 50 51 52 53 54 55 88 57 58 76 60 61 62 63 64 65 66 67 68 70 69 89 85 86 87 69 84 81 82 81 83 89 85 86 87 83 89
4 17 6 7 17 20 10 19 22 13 14 123 123 123 55 9 24 22 23 24 25 26 27 28 29 30 31 32 33 34 35 36 37 38 39 40 114 43 9 45 46 47 48 49 50 51 52 53 61 55 56 57 58 59 53 54 62 64 65 70 67 123 69 97 71 72 73 103 104 77 78 79 80 81 97 83 84 85 86 87
4 79 5 6 177 10 5 26 27 147 158 177 10 5 26 27 147 158 177 10 5 26 35 26 10 5 26 21 22 23 24 25 26 26 21 22 23 24 25 26 26 21 22 23 24 25 26 26 21 22 23 24 25 26 26 21 22 23 24 25 26 26 21 22 23 24 25 26 26 21 22 23 24 25 26 26 21 22 23 24
4 6 10 11 16 17 18 33 58 51 52 51 52 12 48 48 26 28 17 18 36 30 12 51 52 12 44 42 51 52 51 52 127 48 42 51 52 51 52 12 48 25 26 27 28 43 88 30 12 51 52 51 52 127 48 48 24 43 106 59 100 97 60 89 88 32 49 16 43 18 36 27 11 34 142 74 61 59 175 176
4 6 174 211 219 22 56 13 68 66 25 23 127 237 24 54 127 92 28 40 27 110 111 110 111 124 85 39 10 22 238 157 158 37 23 39 10 68 65 38 39 128 127 92 28 40 27 110 111 110 111 124 85 39 10 22 238 157 158 37 23 39 10 68 65 38 39 128 127 92 28 40 27 110 111 110 111 124 85 39
4 11 151 174 193 163 23 83 25 26 27 30 59 33 34 25 36 34 38 39 40 41 42 43 44 45 46 47 48 49 50 51 52 57 68 33 74 75 76 77 78 79 80 81 88 89 24 84 85 86 87 82 89 90 98 100 103 101 151 101 144 115 192 56 196 196 193 7 202 193 9 56 57 89 7 212 213 214
4 27 127 10 11 12 141 10 31 43 34 35 25 52 55 57 61 18 21 81 15 84 19 86 76 98 98 129 130 109 109 103 130 103 103 106 53 101 106 103 27 127 103 102 9 113 114 120 121 132 104 117 124 131 129 130 126 132 133 134 35 25 131 129 9 28 127 124 131 132 133 134 39 40 119 117 121 104 120
4 6 7 8 39 17 28 11 12 13 14 15 16 18 19 20 21 15 11 12 13 14 15 16 18 19 20 21 22 11 12 13 14 15 16 18 19 20 21 22 11 12 13 14 15 16 18 19 20 21 15 11 12 13 14 15 16 18 19 20 21 22 11 12 13 14 15 16 18 19 20 21 22 11 12 13 14 15 16 18
4 6 7 38 9 10 11 12 35 15 16 17 18 19 20 21 22 23 24 25 26 28 30 31 32 13 13 13 8 37 8 37 8 8
4 5 25 14 15 16 17 16 13 25 36 14 15 16 17 16 7 13 36 14 15 16 17 16 25 13 36 14 15 16 17 16 29 13 36 19 20 21 23 23 25 23 23 7 30 25 25 34 35 36
4 45 16 16 27 7 8 48 29 23 30 32 45 10 22 25 26 27 28 10 21 22 25 26 28 28 10 21 22 25 26 28 28 32 21 22 25 26 27 28 10 21 22 25 26 27 28 10 21 22 25 26 28 28 32 21 22 25 26 27 28 10 21 22 25 26 27 28 10 21 22 25 26 28 28 32 21 22 25 26
4 90 107 136 43 9 90 107 105 104 8 9 57 47 54 51 52 49 50 51 52 57 54 55 56 57 58 10 39 40 41 101 99 126 62 65 46 58 126 119 39 40 41 58 101 99 62 169 65 66 168 64 66 170 64 66 168 170 170 43 180 174 67 34 71 73 136 134 99 100 73 35 125 76 10 114 128 129 131 130
4 6 145 134 121 39 13 37 49 28 41 21 57 58 118 119 120 100 105 101 11 98 48 52 49 28 47 48 41 40 66 57 58 119 61 47 48 61 15 114 51 16 97 14 84 40 70 28 49 47 48 77 16 17 50 51 50 51 50 51 19 66 40 18 19 66 100 43 52 119 28 119 120 110 35 42 11 98 84 52
4 184 6 141 162 8 253 6 47 46 110 83 64 79 51 52 53 54 55 159 185 61 12 144 185 171 257 185 171 55 80 51 52 53 54 71 19 277 159 51 52 53 54 94 78 12 118 117 122 271 86 61 74 109 30 83 115 105 109 120 105 225 74 104 184 115 120 83 97 185 53 54 55 159 185 53 54 71 19 277
4 6 7 65 9 10 11 12 13 56 8 21 17 18 19 20 21 65 23 24 25 26 27 28 29 30 31 32 33 34 35 36 37 39 40 8 42 19 44 55 46 47 45 49 50 51 52 53 54 45 56 57 58 59 60 61 62 67 64 15 41 62 67 13 15 16 67 65 68 65 72 65
4 6 58 8 7 104 11 12 13 14 15 16 36 18 19 39 40 41 42 43 45 46 47 48 49 50 51 53 75 73 55 58 10 13 14 15 16 17 18 19 39 40 41 42 43 45 46 47 48 49 50 51 53 95 97 31 61 66 27 28 47 48 49 50 51 53 75 65 55 33 9 57 59 60 67 90 50 78 81 81
4 6 7 8 10 11 31 20 21 39 24 25 26 37 38 23 40 50 40 41 21 35 23 22 24 25 26 38 28 29 30 31 32 33 34 35 36 37 38 23 40 41 42 43 45 46 10 11 23 41 53 46 48 48 8 51 48 53 42 38 42 38 37 38 58 59 41 36 38 61 62
4 42 6 7 9 10 11 12 42 42 15 16 17 18 19 20 21 22 23 24 25 26 27 28 29 30 35 32 33 58 35 81 9 41 7 43 69 52 71 72 73 74 75 76 77 85 80 80 36 79 7 78 86 42 88
4 80 7 8 155 7 84 61 88 9 6 90 33 32 32 33 28 16 15 14 28 14 15 16 28 90 33 86 55 86 50 11 12 13 14 15 16 28 90 33 32 55 86 57 56 59 58 47 65 17 67 68 66 50 65 60 58 59 50 56 95 97 52 53 54 51 95 61 88 9 67 68 66 65 60 57 56 59 58 50
4 6 7 61 9 77 67 70 60 58 63 14 15 17 17 12 20 52 22 23 20 26 29 28 29 30 31 32 9 6 71 36 35 37 70 68 40 27 42 43 44 53 46 47 53 49 50 51 52 53 54 55 56 53 62 60 59 9 71 62 63 64 70 61 75 76 69 12 79 80 42 82
4 7 8 25 11 15 83 12 38 38 39 40 41 42 89 48 42 50 33 92 90 19 40 41 42 89 48 35 21 75 21 51 31 29 122 107 32 20 21 32 122 123 76 125 126 127 128 17
4 46 53 6 7 8 10 10 11 19 44 44 42 28 29 32 21 20 27 28 29 23 45 24 21 20 27 28 29 30 31 32 33 32 41 41 10 11 5 17 54 13 53 10 11 58 44 19 44 42 43 44 45 46 46 51 53 13 53 10 11 19 44 44 42 28 29 32 33 37 38 39 40 53 24 23 24 24 21 20
4 6 27 9 15 14 14 56 16 6 37 9 20 14 29 16 43 31 32 33 35 19 19 16 19 21 19 23 35 23 19 23 19 21 19 28 62 63
4 6 197 8 48 50 113 142 15 28 29 30 31 142 15 77 37 133 51 113 11 12 13 186 114 195 86 194 192 196 143 15 113 11 12 13 186 114 23 53 54 97 35 142 15 28 29 30 31 106 142 15 61 37 133 51 241 142 15 28 29 30 31 106 142 15 77 37 133 51 241 208 21 93 111 64 204 54 148 231
4 82 14 19 48 22 223 224 225 232 22 227 229 265 70 71 40 41 42 43 44 45 46 47 48 49 50 51 52 236 54 55 56 57 44 60 45 294 12 64 65 66 70 281 70 71 72 70 71 72 294 280 64 65 66 117 107 119 109 82 197 107 173 88 135 122 133 241 240 220 125 145 180 203 204 205 206 208 209 210
4 19 6 7 8 9 10 11 12 13 14 15 16 17 18 46 36 21 22 80 24 25 26 42 28 29 30 31 108 33 110 35 114 37 38 39 40 41 27 43 44 45 36 47 50 49 50 51 52 53 54 55 56 57 58 59 60 61 62 63 64 21 66 67 68 69 70 72 75 19 75 36 75 94 94 55 79 49 81 82
4 8 9 10 63 51 44 46 55 56 78 60 79 80 47 82 49 50 85 86 70 51 52 53 35 36 99 100 101 78 79 80 47 82 49 84 85 86 70 51 88 52 89 90 91 92 93 94 10 96 97 98 99 100 101 60 86 70 125 91 92 93 94 96 97 98 99 100 101 60 86 70 125 91 92 93 94 6 53 97
4 92 8 9 15 11 12 13 38 22 47 48 45 46 16 35 31 36 35 19 26 30 31 36 35 47 48 45 46 16 43 59 41 33 50 52 54 55 56 53 77 79 78 80 41 84 83 39 94 95 96
4 45 39 98 93 9 10 12 13 32 12 13 11 26 45 21 39 37 73 74 72 79 73 74 74 71 72 73 74 74 72 79 73 74 37 77 78 79 80 74 74 71 72 73 74 74 72 79 73 74 37 77 78 79 80 74 74 71 72 73 74 74 72 79 73 74 70 77 78 79 80 14 95 93 44 70 15 16 17 18
4 22 6 51 10 9 6 52 9 30 27 14 15 13 17 18 19 20 22 23 22 55 26 27 28 29 30 35 33 36 31 40 44 47 47 8 53 25
4 14 53 101 105 6 105 102 9 34 69 40 41 27 72 73 74 75 76 77 78 79 80 81 27 83 143 37 38 39 64 66 44 45 46 91 20 93 116 95 106 97 140 142 100 102 101 118 103 104 102 106 43 123 43 110 101 112 113 114 7 116 120 102 127 120 102 137 125 123 123 134 119 141 99 143 86 145 146 147
4 5 87 21 24 14 126 18 35 32 107 127 59 105 105 105 20 41 14 126 12 11 18 19 14 102 105 105 102 41 20 12 64 35 11 26 124 30 8 39 36 91 103 12 74 72 73 69 70 74 68 91 103 107 96 97 98 100 123 74 72 73 74 69 70 91 103 107 96 97 98 100 52 59 105 89 81 80 52 101
4 6 38 56 18 23 19 24 23 27 20 29 30 41 14 62 58 59 60 61 62 14 52 27 20 13 46 16 41 58 59 60 61 62 16 10 27 20 13 10 41 14 23 25 24 23 19 27 20 29 30 41 16 62 58 59 60 61 62 16 10 27 20 13 10 41 16 23 19 24 23 25 27 20 29 30 41 16 62 58
4 6 8 63 10 6 56 47 39 21 22 23 24 25 26 27 34 28 29 36 37 40 41 42 43 44 45 44 47 46 47 64 29 36 37 40 51 52 53 54 55 57 59 60 62 62 63 61 66 50 69 70 71
4 7 8 38 10 10 11 52 51 29 30 34 35 37 16 16 21 24 20 59 66 24 20 44 5 68 46 16 16 21 56 56 66 70 71 24 71 78 20 87 38 65 68 58 53 56 56 71 70 71 24 71 24 66 70 71 85 71 24 65 68 58 61 56 56 66 70 71 24 71 24 71 22 65 68 58 61 56 56 71
4 6 7 8 27 77 48 14 12 19 20 21 33 23 24 25 29 80 29 44 17 56 21 41 42 43 53 46 45 44 33 31 32 22 34 35 36 28 29 38 73 49 41 42 43 44 17 46 34 35 36 25 29 34 44 36 35 25 29 13 43 67 44 41 42 43 46 44 22 36 34 35 36 28 29 67 43 67 44 41
4 6 9 28 28 21 22 24 21 28 24 21 22 22 21 22 24 26 21 22 22 21 24 22 21 22 22 21 22 22 21 22 22 21 22 24
4 6 9 8 7 10 11 12 13 14 15 63 68 70 19 37 38 39 40 41 43 44 45 46 47 48 49 48 51 31 55 55 56 57 58 59 60 61 62 33 68 18 19 37 38 39 40 41 43 44 45 46 47 48 49 48 51 31 55 55 56 57 58 59 60 61 62 33 68 18 19 37 38 39 40 41 43 44 45 46
4 6 87 86 8 6 86 13 14 15 16 17 18 26 21 28 61 35 21 22 31 69 49 50 66 68 117 23 117 31 13 14 15 16 17 18 26 26 28 61 29 51 66 50 50 49 112 110 76 55 87 84 89 85 55 52 52 52 101 102 107 106 127 108 110 109 110 104 22 113 110 52 104 117 68 120
4 6 7 40 8 9 11 48 47 13 14 15 16 40 24 25 26 18 28 22 21 31 59 38 56 11 15 13 14 15 16 57 49 50 11 45 46 47 48 49 35 51 52 53 50 44 57 13 14 15 16 57 64 27 19 20 30 29 23 24 25 26 18 28 29 21 31 59 38 56 57 57 23 28 29 21 31 59 38 56
4 6 41 134 9 10 54 21 13 14 16 70 43 20 21 22 20 24 25 26 27 28 29 30 31 32 33 34 35 36 37 38 39 40 114 42 43 44 45 46 47 48 49 50 51 52 60 11 55 56 57 58 59 53 61 63 65 72 67 94 95 93 94 95 92 96 100 98 99 100 101 102 103 104 105 109 107 108 103 110
4 35 9 10 14 15 8 9 13 14 11 15 23 23 24 24 57 47 48 13 14 10 14 11 15 23 25 49 51 50 8 52 49 57 25 34 35 33 34 35 34 35 47 48 49 46 47 48 49 51 50 52 51 53 60 58
4 6 7 8 6 28 7 8 6 25 27 34 30 32 32 32 40 8 41 19 16 17 16 17 14 12 19 20 41 20 19 16 17 28 19 20
4 6 7 8 23 6 11 12 13 14 15 16 17 18 19 20 21 21 78 24 25 26 27 28 21 30 31 32 33 34 35 36 37 38 39 36 37 38 24 25 26 27 28 21 30 31 32 33 34 35 36 37 38 39 40 41 42 43 44 45 62 47 48 49 50 51 52 53 54 55 57 43 74 71 72 71 43 70 67 68
4 6 113 139 9 10 18 12 13 14 16 70 45 23 12 22 23 24 25 26 27 28 29 30 32 33 34 35 36 37 38 39 40 141 42 137 44 9 46 47 48 49 50 51 52 53 61 55 11 57 58 59 60 54 62 63 64 65 66 67 137 71 86 80 74 75 76 77 78 79 80 81 82 83 84 85 72 87 88 89
4 17 76 6 66 8 15 15 10 9 29 30 65 32 33 76 35 19 23 24 25 26 27 76 40 41 44 67 43 44 45 46 47 49 50 47 52 54 54 35 19 35 56 57 58 59 60 61 62 63 7 65 68 66 65 68 66 65 32 33 71 72 72 8 75 71 75 69 50 35
4 7 47 19 19 20 27 29 18 12 43 40 41 42 43 40 41 42 43 40 41 42 43 40 41 42 43 45 40 41 42 43 6 46 47 45 5 52 46 47 51 52 53 55 55 55 53 35 56 57 53 35 28 43 53 55 55 53 35 6 51 11 28 30
4 5 43 8 22 11 14 25 38 26 20 17 18 19 20 17 18 19 20 17 18 19 20 17 18 19 20 17 18 19 20 17 18 19 20 17 18 19 20 17 18 19 20 17 18 19 20 17 18 19 20 17 18 19 20 17 18 19 20 17 18 19 20 17 18 19 20 17 18 19 20 17 18 19 20 17 18 19 20 17
4 6 15 28 6 11 13 16 13 18 22 21 28 20 27 28 28 9 27 9 28 11 13 16 18 22 21 28 20 27 28 9 27 9
4 6 7 107 23 9 10 82 9 10 57 8 57 16 17 16 21 36 23 67 54 26 27 28 29 30 31 32 33 34 120 36 37 38 39 90 39 43 90 37 38 23 66 67 115 115 7 54 23 66 38 39 17 90 41 43 90 37 38 41 90 17 82 90 37 38 41 90 39 43 90 75 74 76 81 79 90 84 85 102
4 6 171 9 10 32 33 34 74 60 61 63 67 65 17 24 25 26 27 28 29 30 31 10 32 33 34 35 36 72 49 38 39 99 100 111 22 113 17 89 15 117 118 119 120 121 122 123 124 72 49 87 51 60 61 62 63 72 49 87 46 47 48 49 50 51 52 53 54 19 90 91 11 93 94 95 96 97 39 99
4 77 5 25 23 7 5 95 40 41 42 43 95 36 39 36 68 69 70 71 72 73 74 75 76 77 78 79 80 81 82 83 84 85 86 87 88 89 90 91 92 93 94 51 50 119 98 102 101 95 44 111 101 153 17 112 20 21 22 24 26 25 23 27 28 29 30 31 32 33 34 65 144 127 92 93 31 135 144 127
4 5 111 114 8 9 10 119 12 28 20 21 22 23 24 69 22 125 126 127 128 129 28 20 21 22 23 24 69 22 125 126 127 128 129 78 28 67 31 22 76 74 111 39 40 41 42 43 63 46 100 73 74 77 88 46 85 86 46 60 114 115 129 114 109 115 118 129 77
4 7 8 131 10 11 18 21 14 15 64 103 113 70 44 23 21 22 23 24 25 26 27 28 29 30 31 32 33 34 35 36 37 38 39 40 41 64 43 44 45 46 47 48 49 50 51 52 60 61 18 56 57 58 59 60 54 62 63 65 66 67 42 71 72 73 74 75 76 77 78 79 73 81 82 83 84 85 72 107
4 5 39 27 16 17 10 9 10 9 13 14 15 17 14 15 17 14 15 17 14 15 17 14 15 17 10 9 10 10 9 13 14 15 17 14 15 17 14 15 17 14 15 17 14 15 17 14 15 17 14 15 17 14 15 17 14 15 17 14 15 17 14 15 17 14 15 17 14 15 17 14 15 17 14 15 17 14 15 17
4 17 99 19 23 36 54 30 14 28 28 50 54 37 43 14 15 96 97 33 13 98 11 107 55 44 96 97 97 98 11 14 15 96 32 33 13 98 39 6 7 10 13 16 64 70 37 7 10 19 13 13 16 23 10 60 42 95 33 13 87 13 7 10 19 13 65 91 55 57 59 60 80 83 83 93 95 33 13 101
4 6 68 8 30 34 35 36 37 38 39 58 41 42 16 44 45 46 47 48 49 50 51 52 53 54 55 56 57 58 117 127 60 62 71 65 66 67 7 69 71 57 58 98 60 117 28 7 31 8 33 34 35 36 37 38 39 58 41 42 127 44 45 46 47 48 49 50 51 52 53 54 55 56 57 58 117 127 60 62
4 6 7 116 10 11 12 13 130 15 20 17 18 106 20 8 22 74 24 25 26 27 28 27 30 75 31 32 33 47 35 36 37 38 40 41 42 43 44 45 46 11 48 49 50 51 52 53 54 55 56 57 58 59 60 61 62 63 34 65 66 67 68 69 70 73 72 73 74 75 7 76 77 78 84 81 88 133 90 91
4 6 26 13 6 20 50 9 16 20 8 40 10 35 36 8 16 20 40 34 35 18 19 20 20 40 14 21 20 26 40 31 32 38 21 40 31 32 41 21 22 22 23 25 25 26 25 27
4 15 6 40 8 39 6 5 11 12 13 14 7 16 17 18 19 20 21 22 23 24 25 14 19 16 17 18 19 20 21 22 23 24 25 14 19 16 17 18 19 20 21 22 23 24 25 14 40 16 17 18 19 20 21 22 23 24 25 14 40 16 17 18 19 20 21 22 23 24 25 14 7 16 17 18 19 20 21 22
4 6 7 57 8 10 5 12 13 14 15 16 17 18 19 20 21 22 23 24 25 56 28 29 30 31 63 33 34 35 36 37 38 42 20 21 22 23 24 25 8 28 29 30 39 9 33 34 35 36 37 38 42 20 21 22 23 24 25 8 28 29 30 39 9 33 34 35 36 37 38 42 20 21 22 23 24 25 8 28
4 16 46 5 10 28 46 37 20 37 19 33 42 38 39 41 22 38 39 8 30 10 30 27 37 30 38 39 8 20 30 10 33 37 38 39 8 20 41 22 21 50 38 39 8 20 43 48 10 45 45 46 43 31 36 35 50 38 42 41 41 43 44 44 8 49 52 53
4 61 6 61 8 64 20 21 14 20 21 31 32 39 40 6 31 39 40 6 14 20 21 52 11 20 21 22 31 61 11 20 21 22 31 61 25 26 22 21 25 26 61 35 32 33 32 41 65 31 56 57 54 22 54 22 31 25 26 65 11 27 28 30 35 32 33 32 41 56 57 54 43 46 58 50 8 65 58 65
4 6 108 73 72 32 72 27 37 32 72 27 37 38 32 72 27 37 38 32 72 27 37 38 32 72 27 37 38 32 72 27 37 38 32 72 27 37 38 32 72 27 37 38 32 72 27 37 38 32 72 27 37 38 32 72 27 37 38 32 72 27 37 38 32 72 27 37 38 32 72 27 37 38 37 38 32 72 27 30
4 23 63 6 65 67 68 69 14 63 64 65 66 67 68 69 14 93 40 59 60 61 62 63 64 65 66 67 68 69 14 63 64 65 66 67 68 69 6 40 59 60 61 62 63 64 65 66 67 68 69 14 93 25 26 27 28 44 30 31 40 59 122 24 24 24 85 83 84 85 86 82 58 88 90 71 92 93 92 93
