4 20 12 16 17 6 7 9 17 20 9 10 21 6 19 9 10 7 10 7 9 17 6 19 9 17 21 6 7 9 10 7 10 7
4 21 10 14 15 25 20 21 10 14 17 25 19 18 16 19 20 21 10 14 13 35 28 17 25 19 18 20 21 10 14 13 35 28 29 30 34 26 17
4 11 7 5 9 7 5 9 12 11 12 12 17 9 12 12 17 9 12 11 12 12 9 12 11 14 12 12 17 9 12 11 17 12
4 9 19 15 16 17 16 19 20 16 19 20 16 19 17 16 19 20 16 19 20 16 19 20 16 19 20 16 19 20 16 19 20 16 19
4 9 6 7 15 16 25 11 12 22 14 8 9 17 19 18 21 13 12 22 14 15 16 17 19 18 21 13 12 22 14 15 16 17 19 18 21 13 12 22 14 15 16 17 19 18 21 13 12 22 14 15 16 17 19 18 21 13 12 22 14 15 16 17 19 18 21 13 12 22 14 15 9 17 19 18 21 13 12 22
4 7 11 8 9 13 11 12 10 14 15 16 17 18 15 16 17 18 7 11 12 10 14 15 16 17 18 15 16 17 18 7 11 12
4 5 13 5 13 13 5 13 21 14 14 24 25 26 21 14 14 24 25 26 10 21 14 14 24 25 26 10 20 21 14 24 25 26
4 18 24 8 10 11 9 15 29 30 31 32 29 29 9 11 9 11 18 13 11 9 29 29 29 31 32 18 27 25 24 9 29 11
4 9 10 7 8 9 10 19 16 13 14 15 16 17 21 19 20 21 22 22 24 14 19 27 28 29 30 31 10 30 31 23 16 14
4 8 13 7 9 10 8 24 22 23 12 15 14 14 23 12 22 23 19 22 23 12 14 14 10 8 23 19 22 23 12 15 14 14 23 12 22 19 22 23 19
4 19 8 10 43 25 39 27 42 43 19 21 28 30 35 30 47 37 46 22 17 37 46 22 17 37 46 22 17 37 46 22 47 37
4 6 6 9 10 11 12 13 19 20 21 22 23 24 25 26 23 21 22 23 17 25 26 19 20 21 22 23 15 25 26 23 21 22
4 10 5 6 7 6 7 9 10 11 8 9 9 10 11 8 9 9 10 8 8 9 9 10 11 8 8 9 9 10 8 9 10 11
4 29 6 13 14 24 25 26 27 28 29 7 8 18 11 12 29 13 14 18 20 13 13 14 26 27 28 29 33 6 13 14 18 11 12
4 6 7 8 9 10 45 12 13 17 15 14 18 19 20 21 31 23 24 6 14 27 28 29 30 31 47 33 34 35 36 37 38 39 40 55 42 43 44 45 46 47 48 49 50 51 52 53 50 41 6 55 58 6 55 54 62
4 17 6 7 8 17 18 11 11 21 15 15 19 20 21 15 19 18 19 11 21 15 15 15 20 21 15 19 18 19 11 21 15 15
4 6 7 8 9 10 45 12 13 26 15 17 18 19 20 21 22 23 24 6 14 27 28 29 30 31 32 33 34 35 36 37 38 39 40 57 42 43 44 11 46 32 48 49 61 51 52 53 61 55 6 57 58 6 55 54 62
4 5 8 5 6 8 5 6 8 5 6 5 8 6 5 8 5 6 8 5 6 8 5 6 8 5 6 8 5 6 8 6 8 5
4 6 13 10 17 10 11 12 7 14 15 11 12 7 14 15 11 12 7 14 15 11 12 7 14 15 22 18 21 21 22 11 24 26 27 28
4 5 18 16 8 16 8 16 24 18 25 24 24 22 25 24 18 16 8 25 24 22 16 24 18 25 24 22 16 8 25 24 22 25
4 6 7 8 9 12 13 28 41 54 44 20 85 24 26 27 29 29 43 31 45 58 47 67 68 8 9 12 49 38 51 52 42 42 43 18 45 58 69 67 68 61 62 51 52 42 42 30 18 45 32 87 67 68 61 62 51 52 42 42 43 18 45 58 69 67 68 61 50 51 52 42 42 43 18 45 58 69 67 68
4 7 14 7 13 18 7 13 13 18 15 13 14 13 13 14 15 7 13 18 15 7 13 14 15 7 13 14 15 7 13 14 15 7 13 14
4 6 8 9 9 12 12 8 9 12 9 12 8 9 12 8 9 12 9 12 8 9 12 9 12 8 9 9 12 8 9 12 9 12
4 9 7 8 8 9 7 8 8 6 7 8 8 6 7 8 8 6 7 8 8 6 7 8 8 6 7 8 8 6 7 8 8 6
4 6 13 14 15 18 9 13 14 15 14 15 14 15 14 15 14 18 6 14 15 14 18 12 15 14 18 18 12 13 14 15 18 21
4 5 16 5 16 9 9 5 16 18 11 12 8 19 11 12 16 10 16 11 23 21 22 23 21 18 19 11 12 8 19 11 21 22 23
4 7 6 7 9 15 11 16 15 12 13 14 15 16 15 12 13 14 15 16 15 16 15 12 13 14 15 16 15 12 13 14 15 16 17
4 18 6 51 8 9 29 32 49 12 22 10 15 17 28 30 17 28 45 33 34 22 44 17 28 11 6 31 11 34 32 25 23 22 15 36 15 20 28 26 27 45 33 34 22 44 17 28 30 48 41 34 22 44 17 28 30
4 8 16 12 7 17 15 7 12 14 18 14 8 15 7 12 15 13 12 14 18 8 13 15 16 12 15 13 18 14 8 12 15 16
4 7 7 9 18 9 9 18 9 9 18 9 10 18 9 9 18 9 10 18 9 9 18 9 10 18 9 10 18 9 10 18 9 10
4 57 6 9 10 11 12 13 8 15 16 17 18 19 20 21 17 23 24 25 26 39 28 29 32 31 32 33 51 42 35 35 37 35 41 33 51 44 53 46 47 53 46 47 53 49 60 63 44 48 66 67 57 69 7 22 72 61 74 42 34 44 48 66 67 57 69 7 17 72 61 74 42 61 44 53 46 47 53 49
4 13 23 22 23 21 15 12 19 20 24 16 22 27 21 23 13 23 23 23 6 12 22 21 16 7 6 20 24 14 22 23 21 15 12 19 20 24 16 22 23 21 23
4 15 6 7 8 9 10 11 12 19 14 19 16 17 28 15 20 21 22 23 24 25 26 27 28 29 18 31 32 33 34 35 36 37 38 39
4 31 16 15 7 8 9 25 8 9 37 13 31 15 14 39 32 29 12 14 8 9 25 17 29 12 14 8 9 10 32 11 12 14
4 13 5 12 15 12 11 14 5 18 15 18 11 14 5 18 14 18 11 14 5 18 15 18 12 11 12 5 18 15 18 12 11 14
4 8 7 9 11 10 10 21 14 23 13 9 6 7 8 11 10 21 14 23 13 9 21 8 11 10 21 14 23 13 9 21 8 11 10 9
4 24 17 16 24 21 16 25 21 13 25 21 16 25 24 13 25 21 16 24 25 21 16 24 25 21 16 24 25 21 16 24 25 26
4 11 10 7 10 5 22 8 20 20 20 13 22 8 13 21 10 10 5 21 10 10 5 21 10 10 5 21 10 10 5 21 10 7
4 5 6 7 8 9 10 11 12 14 18 19 17 18 19 26 13 5 6 7 8 9 10 11 12 14 24 18 12 14 25 26 26 17
4 6 7 8 9 10 11 12 13 14 15 13 17 18 19 20 21 22 23 24 25 26 27 29 29 30 22 23 24 25 26 27 28 10 30
4 14 5 6 7 8 10 9 12 13 14 15 16 17 29 19 20 21 22 23 24 25 11 77 28 29 30 31 32 34 35 36 37 38 39 40 41 23 72 66 63 64 65 37 45 46 39 40 41 23 72 37 45 58 49 50 51 52 53 55 56 56 57 58 60 61 34 36 37 38 39 40 41 23 72 66 63 64 65 37
4 6 7 5 8 17 18 11 12 13 14 14 16 17 18 16 17 18 9 12 13 14 20 21 14 20 19 17 18 9 12 13 14 20 21
4 14 39 21 22 12 7 19 17 39 9 8 33 14 39 37 22 21 30 14 39 32 33 24 31 8 33 14 39 37 22 30 14 39
4 25 13 14 6 15 16 25 22 19 21 22 23 24 25 26 26 27 30 32 33 35 36 20 38 39 40 41 42 16 42 28 22 20
4 5 13 7 11 13 18 18 19 14 14 13 14 13 14 14 13 14 18 18 19 14 14 13 14 5 11 13 18 18 19 14 14 14
4 6 37 8 9 10 11 13 14 15 16 17 18 19 20 21 22 23 24 25 26 27 28 29 30 31 64 33 34 7 38 39 17 41 42 42 42 42 46 47
4 19 6 13 11 6 20 11 19 8 9 19 8 9 8 18 19 8 10 19 8 10 19 8 9 20 11 19 8 10 19 8 10 19 8 9
4 6 9 14 24 21 14 11 22 8 24 14 21 11 22 20 6 12 14 24 21 20 24 21 14 6 11 21 20 24 14 16 21 20
4 6 7 53 11 11 12 13 17 15 16 14 18 19 18 20 27 9 10 23 28 34 35 36 86 13 65 41 42 43 44 45 46 47 48 49 50 51 52 53 54 55 56 67 58 45 60 61 62 63 64 63 66 67 31 32 33 34 35 36 69 8 65 41 41 42 43 44 45 46 47 48 49 50 51 52 53 54 55 56
4 5 6 15 8 5 20 12 13 14 15 38 18 19 22 23 20 42 43 44 45 46 47 27 25 29 34 31 27 25 34 35 36 37 38 39
4 10 6 7 8 10 11 12 10 14 8 16 17 18 10 20 10 11 12 10 14 8 16 17 18 18 11 12 10 14 8 16 17 18
4 7 8 8 10 11 12 13 14 15 20 21 21 22 11 15 10 11 12 13 14 15 20 21 13 10 11 12 13 10 15 20 21 22
4 6 7 8 9 10 11 13 14 11 20 17 18 19 20 21 22 23 24 34 26 27 28 29 30 32 33 25 35 36 37 38 29 30
4 16 13 14 11 12 13 9 15 8 9 15 13 14 10 11 12 13 9 15 8 9 15 13 10 10 11 12 13 9 15 8 9 15
4 17 17 17 12 17 17 12 17 17 12 17 17 12 17 12 17 17 12 17 12 17 17 12 17 12 17 17 12 17 17 12 17 17
4 8 6 7 8 9 11 12 14 15 16 17 18 19 19 6 7 8 7 8 6 7 8 9 11 12 14 15 16 17 18 19 8 21
4 14 11 11 13 14 15 16 18 20 20 21 11 6 7 8 9 25 11 6 7 21 20 21 25 7 7 9 25 11 6 7 21 19
4 9 6 7 8 16 10 11 12 22 14 8 9 17 19 18 21 13 12 22 14 8 9 17 18 19 21 13 12 22 14 8 9 17 18 19 21 13 12 22 14 8 9 17 18 19 21 13 12 22 14 8 9 17 18 19 21 13 12 22 14 8 9 17 18 19 21 13 12 22 14 8 9 17 18 19 21 13 12 22
4 14 15 16 17 18 19 20 21 12 13 14 15 16 17 18 19 20 21 24 25 26 27 28 29 30 31 32 33 9 26 27 28 29 30 31 32 33 25
4 8 6 15 12 15 11 18 19 11 18 19 11 11 18 19 11 11 18 19 11 11 18 19 11 18 19 11 11 18 19 11 18 19
4 26 26 7 16 15 30 32 21 10 12 28 13 25 17 11 8 31 12 28 29 30 16 15 28 30 16 15 28 30 16 15 30 32
4 11 7 8 9 11 12 13 14 15 25 21 18 5 20 21 22 22 22 12 13 14 15 25 21 18 11 20 21 22 22 22 12 13 14 15 16 21 18 11 20 21 22 22
4 6 7 10 15 15 21 22 24 23 25 20 21 22 28 23 25 20 21 22 28 23 25 20 21 22 28 23 25 20 21 22 28 23 25
4 15 16 17 18 19 20 21 22 13 14 15 16 17 18 19 20 21 22 25 26 27 28 29 30 31 32 33 34 35 27 28 29 30 31 32 33 34 26
4 28 27 15 13 28 20 10 13 17 12 15 13 19 19 15 13 20 12 15 13 20 19 15 12 13 19 19 15 13 20 15 12 19
4 8 6 7 8 22 10 11 12 13 14 15 16 21 18 19 22 17 22 23 19 22 17 22 23 19 22 17 22 23 19 22 17 22 23
4 11 11 17 12 14 17 7 7 11 17 10 18 9 14 6 7 11 17 18 9 14 6 7 11 17 18 9 14 6 7 11 17 12 7 9 14 6 7 11 17 18 17 12 7
4 42 6 7 8 9 28 11 11 13 14 21 16 15 18 19 20 17 22 39 25 27 28 29 30 31 32 33 34 35 36 42 20 39 25 41 42 43 34
4 7 6 7 13 9 10 11 12 13 26 15 14 18 19 20 21 31 23 24 9 27 28 29 30 31 32 33 34 35 35 30 22 32 33 34 35
4 31 6 7 8 10 15 12 10 15 7 8 14 10 26 19 20 21 29 30 23 20 9 15 15 14 8 10 15 26 19 25 9 15 15
4 13 13 5 8 8 11 11 6 20 8 9 8 11 11 10 12 12 12 12 18 17 17 18 11 11 10 9 8 11 10 9 20 8
4 15 6 8 11 12 10 13 11 12 10 13 11 10 9 10 8 11 12 15 13 11 10 13 11 12 15 13 11 10 9 10 8 11 12
4 6 8 15 10 11 12 13 15 19 14 10 11 12 13 15 19 14 10 29 14 6 8 15 10 16 14 6 8 15 10 16 14 6 8 15 10 19 14
4 9 18 17 18 8 12 14 18 17 21 16 22 14 12 21 22 22 14 18 17 21 22 22 21 22 22 17 18 6 9 21 22 22
4 8 7 13 9 10 11 12 8 14 15 16 18 19 28 22 28 22 16 18 14 15 22 19 25 26 27 18 28 30 30 30 29 25 26
4 20 7 8 11 12 23 14 15 16 17 18 19 20 22 23 14 15 16 17 18 19 20 22 23 14 15 16 17 18 19 20 22 23
4 6 8 7 6 11 7 8 12 8 12 8 7 6 11 12 8 12 8 7 6 11 12 8 12 8 7 6 11 12 8 12 8 7
4 19 6 12 10 13 12 10 11 13 12 10 11 19 12 10 6 12 10 11 13 12 10 11 19 12 10 6 12 10 11 13 12 10 11
4 11 11 19 13 14 10 11 18 20 20 11 16 14 14 7 8 9 12 11 18 20 11 16 9 12 11 14 18 7 8 9 12 18 11
4 19 6 17 24 18 25 35 35 11 35 18 25 12 19 19 19 19 12 28 24 25 12 35 18 11 12 19 19 19 12 18 11 12 28
4 7 26 18 26 22 30 30 29 29 12 30 22 23 23 19 22 30 12 30 29 29 12 30 22 23 19 22 30 12 30 29 29 12 30 22 23 23 19 22
4 5 6 7 8 5 10 11 12 13 14 15 16 9 18 15 20 20 20 10 11 12 13 14 15 16 5 18 15 20 20 20 10 11 12 13 23 15 16 5 18 15 20 20
4 5 6 7 8 5 10 12 13 14 15 16 18 36 21 22 46 42 43 44 45 38 42 48 49 50 51 16 52 59 60 34 25 57 58 59 60
4 6 6 16 15 6 16 13 13 12 13 11 8 9 10 11 12 13 13 11 12 13 12 13 11 8 9 10 11 12 13 13 12 13
4 7 6 6 8 9 10 36 12 13 14 21 16 17 18 19 20 6 22 23 24 25 10 36 6 29 30 31 32 33 34 35 36 24 29 30 31 32 33 34 35 36
4 7 8 8 17 17 18 9 10 9 10 9 10 9 11 10 9 7 8 13 18 19 9 10 9 11 10 9 11 10 9 7 8 13
4 6 7 10 17 10 11 12 13 14 15 23 12 13 14 15 11 9 18 21 21 22 23 24 26 27 28 11 26 27 28 23 26 27 28
4 10 29 13 24 28 15 28 14 11 28 28 24 17 22 18 18 18 18 18 18 18 18 18 18 18 18 18 18 18 18 18 18 16
4 12 6 6 7 8 8 14 10 11 12 13 14 11 12 13 14 11 12 13 14 11 12 13 14 11 12 13 14 11 12 13 14 11
4 18 44 21 44 21 44 39 39 37 44 25 7 17 36 14 22 37 44 25 17 36 27 37 44 12 22 37 44 25 17 36 27 22
4 7 7 11 10 9 13 12 12 13 12 15 9 13 12 15 9 13 12 12 7 15 9 13 12 12 15 9 13 12 12 9 13 9
4 14 6 11 8 9 10 15 12 19 20 21 30 25 27 28 29 30 29 30 10 33 34 35 30 25 27 28 29 30 29 10 33 34 35
4 21 6 5 8 9 10 11 12 13 14 15 16 17 18 19 20 7 22 23 24 25 26 23 10 23 24 25 26 23 10 23 24 25 26
4 41 7 8 53 25 37 44 27 28 26 54 15 38 39 40 45 22 22 27 28 22 12 51 12 51 39 40 41 22 7 53 25 52 34 18 22 54 15 10 39 40 45 22 22 27 28 22 12 51 12 51 39 40 41 22 7 53 57 52 34 18 22 54 15 38 39 40 45 22 22 27 28 22 12 51 12 51 39 40
4 33 76 49 9 10 73 69 70 61 76 49 63 26 75 82 65 82 63 53 75 82 65 82 63 26 75 82 65 82 63 26 75 82
4 16 17 18 19 9 20 19 12 13 9 15 16 17 18 19 20 19 12 13 9 15 16 17 18 19 20 19 12 15 16 17 18 19 20 19 20
4 7 14 17 8 9 10 11 12 19 12 19 16 17 18 13 20 21 21 9 10 11 12 19 12 19 16 17 18 13 20 21 21 9
4 7 8 21 9 10 12 30 14 15 33 17 18 19 20 28 23 24 25 26 28 29 14 15 16 17 18 19 20 28 23 24 25 26 28 29 14 15 16 17 18 19 20 28 23 24 25 26 28 29 14 15 16 17 18 19 20 28 23 24 25 26 28 29 14 15 16 17 18 19 20 28 23 24 25 26 28 29 14 15
4 7 6 8 8 18 7 12 8 9 7 6 9 8 8 18 6 6 8 9 7 9 9 8 8 18 12 6 8 9 7 9 9 8
4 16 15 8 6 12 7 8 13 8 6 11 16 13 16 6 16 13 8 6 11 8 6 16 13 8 6 16 13 15 8 6 16 11
4 16 17 14 10 11 12 13 9 16 17 13 19 18 19 18 13 19 12 13 19 18 19 18 13 19 12 13 19 18 16 17 13 19
4 12 12 12 12 12 12 12 12 12 12 12 12 12 12 12 12 12 12 12 12 12 12 12 12 12 12 12 12 12 12 12 12 12 12 12 12 12 12 12 12 12 12 12 12 12 12 12 12 12 12 12 12 12 12 12 12 12 12 12 12 12 12 12 12 12 12 12 12 12 12 12 12 12 12 12 12 12 12 12
4 37 40 41 42 56 25 22 12 32 83 18 28 48 31 20 62 56 64 65 66 67 81 69 70 71 76 85 48 31 32 62 64 65 78 67 81 69 70 71 76 85 48 31 19
4 6 7 11 12 14 15 18 9 12 14 15 18 9 12 14 15 18 19 27 24 25 27 19 28 28 28 24 25 21 7 11 12 14 18
4 23 7 13 14 15 15 18 18 15 26 26 16 21 26 15 26 16 21 26 15 26 25 21 26 15 26 16 21 26 15 26 16 21
4 6 7 15 9 19 25 12 13 14 15 16 18 38 26 27 28 29 34 31 27 33 34 35 36 54 38 39 14 55 65 25 60 61 62 63 64 65
4 29 8 17 64 33 43 19 16 17 18 19 13 40 14 64 17 41 37 38 22 43 19 16 17 18 19 13 40 14 64 17 41 53 54 22 43 19 16 17 18
4 19 5 6 7 17 9 10 21 12 13 14 16 15 17 18 19 20 22 22 21 12 13 14 16 15 17 18 19 20 22 22 21 12 13 14 16 15 17 18 19 20 22 21
4 6 7 8 9 10 45 12 13 14 15 17 18 19 20 21 31 23 24 6 14 27 28 29 30 22 32 33 34 35 36 37 38 39 40 55 42 43 44 11 46 47 48 49 54 51 52 53 54 55 6 55 58 6 7 50 62
4 7 7 9 15 14 10 9 11 14 16 11 12 16 14 16 11 14 16 16 14 16 11 12 16 14 16 11 14 16 16 12 16 11
4 10 11 10 11 10 11 10 11 10 11 10 11 10 11 10 11 10 11 10 11 10 11 10 11 10 11 10 11 10 11 10 11 10
4 41 5 6 14 9 9 27 12 11 13 8 17 16 15 18 19 20 21 22 19 37 17 22 18 28 29 30 31 32 33 34 35 41 20 38 25 40 41 42 33
4 6 7 13 9 10 11 12 13 14 15 25 18 19 20 30 22 23 6 25 26 27 28 29 21 31 32 33 34 35 36 37 38 39 54 41 42 43 44 45 46 47 48 53 50 51 52 49 40 6 40 57 6 7 59 60
4 12 13 14 8 23 19 16 17 21 10 23 24 25 26 21 10 29 30 30 21 10 23 24 25 26 21 10 29 30 30 21 10 30
4 17 25 15 26 21 20 34 45 33 20 27 42 25 12 13 27 8 10 7 39 20 34 45 33 22 27 8 28 25 12 13 27 8 10 27 45 22 24 25 12 13 27 8 10 27 45 20 34 45 33 22 7 8 28 25 12 13 27 8 10 27 45 22 24 25 12 13 27 8 10 27 45 20 34 45 33 22 7 8
4 8 5 19 35 36 15 13 27 8 12 14 27 6 16 6 16 6 16 20 8 14 27 8 12 31 28 27 19 16 6 16 6 16 20
4 29 21 11 11 7 7 12 13 18 18 18 18 28 29 24 17 18 18 6 20 21 11 10 28 29 24 17 18 18 28 29 24 28 29
4 6 7 6 7 8 9 10 11 12 26 27 16 36 16 37 32 22 35 38 39 40 41 42 43 44 30 24 43 40 41 42 43 44
4 18 23 24 11 9 10 11 14 15 16 27 20 21 22 7 23 24 6 9 23 24 15 26 29 28 17 30 31 32 33 34 35 36 37 38
4 16 15 5 6 7 10 12 13 14 12 13 14 12 13 10 12 13 14 12 13 10 12 5 5 16 8 9 13 14 12 13 14 12
4 6 17 18 9 9 10 11 15 23 7 8 23 12 13 12 11 14 19 7 16 20 7 18 22 23 17 18 23 12 13 10 11 14 19
4 6 7 8 9 10 11 12 13 14 15 17 18 19 20 21 31 23 24 6 26 27 28 29 30 22 32 33 34 35 36 37 38 39 40 41 42 43 44 45 46 47 48 49 54 51 52 53 54 41 6 60 58 6 60 61 62
4 5 6 14 15 14 9 12 16 12 15 9 14 8 15 12 10 10 12 8 9 13 15 12 8 15 10 12 8 9 10 13 8 15
4 23 26 19 47 6 19 27 26 25 47 34 27 29 25 22 25 47 15 10 41 22 15 31 20 25 22 15 19 47 15 22 22 25
4 15 17 6 7 8 9 10 12 11 11 14 15 17 18 19 20 21 19 17 15 17 18 19 20 21 19 17 15 17 18 19 20 21
4 6 7 8 9 10 11 14 16 13 14 15 12 17 14 14 9 16 15 12 17 14 9 16 15 12 17 14 14 9 12 15 16 17
4 6 7 7 17 12 13 14 15 16 17 10 16 17 10 11 19 17 12 13 14 15 16 17 12 13 14 15 16 17 10 10 11 19
4 5 6 7 8 36 16 11 12 14 36 15 16 17 20 19 18 21 22 16 24 25 26 27 28 29 30 31 32 33 34 35 36 35 9
4 27 5 6 5 6 19 20 20 21 10 14 11 13 14 14 16 8 15 16 20 21 22 14 24 25 26 27 28 28 27 28 12 17 22
4 13 21 6 27 20 13 12 22 8 9 14 16 16 28 13 12 22 8 9 14 16 16 20 29 22 28 29 22 8 9 14 16 16 20
4 7 22 23 32 17 23 12 11 40 22 23 29 43 44 40 22 23 22 23 43 44 40 22 23 29 43 44 40 22 23 24 22 23
4 11 11 10 9 10 10 11 10 15 11 10 15 11 10 9 10 9 10 11 10 15 11 10 9 10 10 11 10 15 11 10 15 11
4 8 6 7 8 11 12 9 11 10 12 10 8 8 9 11 10 12 10 12 8 8 10 9 10 12 11 8 8 11 12 9 11 11 12
