4 69 38 28 28 32 33 11 40 40 40 21 40 40 40 40 40 40 40 40 40 40 40 40 40 40 40 40 40 40 40 40 40 40 40 40 40 40 40 40 40 40 40 40 40 40 40 40 40 40 40 40 40 40 40 40 40 40 40 40 40 40 40 40 40 40 40 40 40 40 40 40 40 40 40 40 40 40 40 40
4 6 30 9 10 12 13 10 12 13 10 12 13 10 12 13 10 12 13 10 12 13 10 12 13 10 12 13 10 12 13 10 12 13 10 12 13 10 12 13 10 12 13 10 12 13 10 12 13 10 12 13 10 12 13 10 12 13 10 12 13 10 12 13 10 12 13 10 12 13 10 12 13 10 12 13 10 12 13 10
4 53 48 13 10 13 10 13 10 13 10 10 10 10 10 10 10 10 10 10 10 10 10 10 10 10 10 10 10 10 10 10 10 10 10 10 10 10 10 10 10 10 10 10 10 10 10 10 10 10 10 10 10 10 10 10 10 10 10 10 10 10 10 10 10 10 10 10 10 10 10 10 10 10 10 10 10 10 10 10
4 55 14 14 14 44 53 8 48 48 8 41 8 42 41 41 42 41 41 42 41 42 41 41 42 41 41 42 41 42 41 41 42 41 41 42 41 41 42 41 41 42 41 41 42 41 41 41 42 41 41 41 42 41 41 41 42 41 41 41 42 41 41 41 42 41 41 41 42 41 41 41 42 41 41 41 42 41 41 41
4 5 11 7 8 8 9 10 11 11 8 11 11 11 8 11 11 11 8 11 11 11 10 11 11 10 9 11 8 11 11 11 10 11 11 10 9 11 8 11 11 11 10 11 11 10 9 11 8 11 11 11 10 11 11 10 9 11 8 11 11 11 10 11 11 10 9 11 8 11 11 11 10 11 11 10 9 11 8 11
4 10 8 13 13 17 18 19 19 10 10 10 17 18 19 19 17 18 19 10 10 10 17 18 19 18 19 13 13 17 18 19 19 20
4 5 5 27 27 19 19 11 11 11 11 11 11 11 11 11 11 11 11 11 11 11 11 11 11 11 11 11 11 11 11 11 11 11 11 11 11 11 11 11 11 11 11 11 11 11 11 11 11 11 11 11 11 11 11 11 11 11 11 11 11 11 11 11 11 11 11 11 11 11 11 11 11 11 11 11 11 11 11 11
4 5 15 8 8 8 6 10 6 10 6 10 6 10 6 10 6 10 6 10 6 10 6 10 6 10 6 10 6 10 6 10 6 10 6 10 6 10 6 10 6 10 6 10 6 10 6 10 6 10 6 10 6 10 6 10 6 10 6 10 6 10 6 10 6 10 6 10 6 10 6 10 6 10 6 10 6 10 6 10
4 5 22 21 39 21 20 43 10 37 13 14 14 27 33 14 27 33 14 27 33 14 27 33 14 27 33 31 36 27 27 33 13 27 27 33 27 36 13 27 27 33 36 27 36 13 27 27 33 36 27 36 13 27 27 33 36 27 36 13 27 27 33 36 27 36 13 27 27 33 36 27 36 13 27 27 33 27 33 31
4 5 17 19 19 19 19 19 7 7 7 11 11 11 11 11 11 11 17 17 18 18 10 10 11 12 9 9 9 12 9 9 9 12 9 9 9 12 9 9 9 12 9 9 9 12 9 9 9 12 9 9 9 12 9 9 9 12 9 9 9 12 9 9 9 12 9 9 9 12 9 9 9 12 9 9 9 12 9 9
4 5 20 22 8 10 11 11 11 10 11 11 11 11 11 11 11 11 11 11 11 11 11 11 11 11 11 11 11 11 11 11 11 11 11 11 11 11 11 11 11 11 11 11 11 11 11 11 11 11 11 11 11 11 11 11 11 11 11 11 11 11 11 11 11 11 11 11 11 11 11 11 11 11 11 11 11 11 11 11
4 57 46 47 21 38 21 21 33 33 33 33 33 33 33 33 33 33 33 33 33 33 33 33 33 33 33 33 33 33 33 33 33 33 33 33 33 33 33 33 33 33 33 33 33 33 33 33 33 33 33 33 33 33 33 33 33 33 33 33 33 33 33 33 33 33 33 33 33 33 33 33 33 33 33 33 33 33 33 33
4 100 66 79 89 80 46 20 76 107 97 87 14 28 14 28 14 14 28 14 28 100 100 99 100 100 99 87 43 100 100 100 99 87 87 100
4 5 6 11 12 13 13 7 13 7 7 7 7 8 14 9 17 17 17 10 23 19 28 31 31 5 5 5 22 23 19 28 31 5
4 12 16 9 18 16 40 40 40 40 39 19 16 29 24 33 51 52 51 33 52 51 33 52 33 22 33 52 11 47 6 49 49 5
4 37 6 11 12 13 7 13 7 7 7 7 13 7 7 13 7 7 13 7 7 13 7 7 13 7 13 7 7 13 7 13 7 13 7 13 7 13 7 13 7 13 7 13 7 13 7 13 7 13 7 13 7 13 7 13 7 13 7 13 7 13 7 13 7 13 7 13 7 13 7 13 7 13 7 13 7 13 7 13
4 5 11 11 11 11 11 11 11 11 11 11 11 11 11 11 11 11 11 5 10 11 5 5 10 11 11 5 10 11 5 5 10 5
4 41 7 26 19 27 27 23 12 9 11 11 8 42 43 43 43 43 43 43 43 43 43 43 43 43 43 43 43 43 43 43 43 43 43 43 43 43 43 43 43 43 43 43 43 43 43 43 43 43 43 43 43 43 43 43 43 43 43 43 43 43 43 43 43 43 43 43 43 43 43 43 43 43 43 43 43 43 43 43
4 45 45 35 37 38 37 35 37 37 35 36 38 35 38 37 35 38 37 35 38 35 37 37 36 35 37 37 35 37 37 35 36 38 35 38 37 35 38 37 35 38 35 37 37 36 35 37 37 35 37 37 35 36 38 35 38 37 35 38 37 35 38 35 37 37 36 35 37 37 35 37 37 35 36 38 35 38 37 36
4 36 5 5 11 8 9 9 10 8 9 9 10 10 8 9 10 9 10 10 8 9 10 10 10 8 9 10 10 10 10 8 9 10 10 9 10 10 10 8 10 10 10 9 10 10 10 9 10 10 10 9 10 10 10 9 10 10 10 9 10 10 10 8 10 10 10 10 9 10 10 10 8 10 10 10 10 9 10 10
4 19 15 7 6 6 6 6 6 6 15 7 6 6 6 6 6 6 6 6 6 6 6 6 6 6 6 6 6 6 6 6 6 6 6 6 6 6 6 6 6 6 6 6 6 6 6 6 6 6 6 6 6 6 6 6 6 6 6 6 6 6 6 6 6 6 6 6 6 6 6 6 6 6 6 6 6 6 6 6
4 5 93 77 107 109 60 19 19 19 19 19 19 19 19 19 19 19 19 19 19 19 19 19 19 19 19 19 19 19 19 19 19 19 19 19 19 19 19 19 19 19 19 19 19 19 19 19 19 19 19 19 19 19 19 19 19 19 19 19 19 19 19 19 19 19 19 19 19 19 19 19 19 19 19 19 19 19 19 19
4 5 31 10 33 33 33 33 33 33 33 33 33 33 33 33 33 33 33 33 33 33 33 33 33 33 33 33 33 33 33 33 33 33 33 33 33 33 33 33 33 33 33 33 33 33 33 33 33 33 33 33 33 33 33 33 33 33 33 33 33 33 33 33 33 33 33 33 33 33 33 33 33 33 33 33 33 33 33 33
4 5 24 24 11 24 20 20 24 20 24 20 24 20 24 20 24 20 24 20 24 20 24 20 24 20 24 20 24 20 24 20 24 20 24 20 24 20 24 20 24 20 24 20 24 20 24 20 24 20 24 20 24 20 24 20 24 20 24 20 24 20 24 20 24 20 24 20 24 20 24 20 24 20 24 20 24 20 24 24
4 27 12 12 7 7 7 7 7 7 6 7 6 7 6 7 6 7 7 6 7 6 7 6 7 6 7 6 7 7 6 7 6 7 6 7 6 7 6 7 7 6 7 6 7 6 7 6 7 6 7 7 6 7 6 7 6 7 6 7 6 7 7 6 7 6 7 6 7 6 7 6 7 7 6 7 6 7 7 6
4 5 5 7 7 14 24 24 24 14 24 10 18 18 18 18 23 31 28 22 22 22 22 22 22 22 22 34 5 5 5 28 31 7
4 5 44 44 31 13 13 8 53 13 8 53 13 13 13 13 13 13 13 13 13 8 15 13 13 13 13 8 44 13 13 13 13 13 8 44 13 13 13 13 8 44 13 13 13 13 8 44 13 13 13 13 8 44 13 13 13 13 8 44 13 13 13 13 8 44 13 13 13 13 8 44 13 13 13 13 8 44 13 13
4 5 27 27 15 14 9 9 18 18 7 7 8 15 15 10 9 18 18 20 20 7 7 18 18 20 20 20 5 5 31 20 5 5
4 38 23 14 24 24 11 24 11 24 15 15 15 15 11 15 15 15 11 15 24 24 11 24 11 15 24 11 24 11 15 15 15 24 24 11 24 11 15 24 11 24 11 15 15 15 24 24 11 24 11 15 24 11 24 11 15 15 15 24 24 11 24 11 15 24 11 24 11 15 15 15 24 24 11 24 11 15 24 11
4 9 98 99 99 15 32 32 32 32 32 32 32 32 32 32 32 32 32 32 32 32 32 32 32 32 32 32 32 32 32 32 32 32 32 32 32 32 32 32 32 32 32 32 32 32 32 32 32 32 32 32 32 32 32 32 32 32 32 32 32 32 32 32 32 32 32 32 32 32 32 32 32 32 32 32 32 32 32 32
4 20 8 30 29 37 37 35 13 11 12 11 13 11 12 11 12 32 32 13 11 12 32 32 12 32 13 11 12 32 32 12 32 13 11 12 32 32 12 32 13 11 12 32 32 12 32 13 11 12 32 32 12 32 13 11 12 32 32 12 32 13 11 12 32 32 12 32 13 11 12 32 32 12 32 13 11 12 32 12
4 49 35 13 24 36 24 17 36 15 15 36 15 15 36 15 15 24 15 15 15 24 15 15 15 24 15 15 15 24 15 15 15 24 15 15 15 24 15 15 15 24 15 15 15 24 15 15 15 24 15 15 15 24 15 15 15 24 15 15 15 24 15 15 15 24 15 15 15 24 15 15 15 24 15 15 15 36 15 15
4 14 7 7 10 7 7 9 10 10 7 21 7 21 14 13 26 14 14 13 26 14 14 13 26 14 14 13 26 14 14 13 26 13
4 75 30 44 31 35 33 33 33 33 33 33 33 33 33 33 33 33 33 33 33 33 33 33 33 33 33 33 33 33 33 33 33 33 33 33 33 33 33 33 33 33 33 33 33 33 33 33 33 33 33 33 33 33 33 33 33 33 33 33 33 33 33 33 33 33 33 33 33 33 33 33 33 33 33 33 33 33 33 33
4 14 16 23 26 18 16 23 20 25 19 19 19 24 7 30 9 25 25 14 24 24 14 7 30 9 25 25 14 24 24 14 7 30 5
4 5 15 12 12 10 10 41 9 10 10 41 41 41 41 41 41 41 41 41 41 41 41 41 41 41 41 41 41 41 41 41 41 41 41 41 41 41 41 41 41 41 41 41 41 41 41 41 41 41 41 41 41 41 41 41 41 41 41 41 41 41 41 41 41 41 41 41 41 41 41 41 41 41 41 41 41 41 41 41
4 38 26 7 16 32 32 32 32 10 24 13 10 26 37 11 27 32 32 32 13 24 13 32 10 24 13 32 10 24 13 32 32 38
4 75 36 58 49 45 41 41 41 41 41 41 41 41 41 41 41 41 41 41 41 41 41 41 41 41 41 41 41 41 41 41 41 41 41 41 41 41 41 41 41 41 41 41 41 41 41 41 41 41 41 41 41 41 41 41 41 41 41 41 41 41 41 41 41 41 41 41 41 41 41 41 41 41 41 41 41 41 41 16
4 16 89 137 8 144 136 113 113 143 144 136 113 113 143 144 136 113 113 143 144 136 113 113 143 144 136 113 113 143 144 136 113 113 143 144 136 113 113 143 144 136 113 113 143 144 136 113 113 143 144 136 113 113 143 144 136 41 113 143 144 136 113 113 143 144 136 113 113 143 144 136 113 113 143 144 136 113 41 143
4 5 6 25 14 21 14 44 34 34 34 9 6 15 15 55 69 33 33 63 69 69 5 48 67 5 5 55 69 33 5 5 5 48 67 5
4 15 38 9 8 7 8 8 8 8 8 7 8 8 8 7 8 8 8 8 7 8 8 8 8 7 8 8 8 8 7 8 8 7 68
4 31 6 6 8 21 22 15 21 21 21 21 18 21 21 21 21 21 21 21 21 21 21 21 21 21 21 21 21 21 21 21 21 21 21 21 21 21 21 21 21 21 21 21 21 21 21 21 21 21 21 21 21 21 21 21 21 21 21 21 21 21 21 21 21 21 21 21 21 21 21 21 21 21 21 21 21 21 21 18
4 5 15 15 9 55 22 47 47 47 47 47 47 47 47 47 47 47 47 47 47 47 47 47 47 47 47 47 47 47 47 47 47 47 47 47 47 47 47 47 47 47 47 47 47 47 47 47 47 47 47 47 47 47 47 47 47 47 47 47 47 47 47 47 47 47 47 47 47 47 47 47 47 47 47 47 47 47 47 47
4 38 15 31 7 7 31 31 31 31 31 7 31 31 31 31 31 7 31 31 31 31 7 31 31 31 7 31 31 31 31 7 31 31 31 7 31 31 31 31 7 31 31 31 7 31 31 31 31 7 31 31 31 7 31 31 31 31 7 31 31 31 7 31 31 31 31 7 31 31 31 7 31 31 31 31 7 31 31 7
4 34 14 13 13 13 16 21 21 11 8 8 8 8 8 8 8 8 8 8 8 8 8 8 8 8 8 8 8 8 8 8 8 8 8 8 8 8 8 8 8 8 8 8 8 8 8 8 8 8 8 8 8 8 8 8 8 8 8 8 8 8 8 8 8 8 8 8 8 8 8 8 8 8 8 8 8 8 8 8
4 5 26 18 15 26 38 27 43 30 31 31 46 52 51 32 7 52 32 51 32 52 32 52 32 55 38 36 57 39 39 5 5 42 43 45 31 46 31 31 46 52 55 57
4 5 8 7 7 12 12 12 12 12 12 12 12 12 12 12 12 12 12 12 12 12 12 12 12 12 12 12 12 12 12 12 12 12 12 12 12 12 12 12 12 12 12 12 12 12 12 12 12 12 12 12 12 12 12 12 12 12 12 12 12 12 12 12 12 12 12 12 12 12 12 12 12 12 12 12 12 12 12 12
4 7 18 14 26 26 26 26 9 14 16 16 9 14 26 26 24 24 24 24 21 9 14 16 16 16 9 14 26 26 24 24 24 24 21 9 14 16 16 16 9 14 26 26 24 24 24 24 21 9 14 16 16 16 9 14 26 26 24 24 24 24 21 9 14 16 16 16 9 14 26 26 24 24 24 24 21 9 14 16
4 88 79 81 83 11 21 21 21 21 21 21 21 21 21 21 21 21 21 21 21 21 21 21 21 21 21 21 21 21 21 21 21 21 21 21 21 21 21 21 21 21 21 21 21 21 21 21 21 21 21 21 21 21 21 21 21 21 21 21 21 21 21 21 21 21 21 21 21 21 21 21 21 21 21 21 21 21 21 21
4 7 11 11 50 51 52 63 63 66 66 66 66 66 59 56 43 7 7 16 43 6 7 7 16 43 7 7 16 6 7 43 7 7
4 5 27 11 12 19 11 12 19 26 22 22 36 35 40 40 40 40 40 40 40 40 40 40 40 40 40 40 40 40 40 40 40 40 40 40 40 40 40 40 40 40 40 40 40 40 40 40 40 40 40 40 40 40 40 40 40 40 40 40 40 40 40 40 40 40 40 40 40 40 40 40 40 40 40 40 40 40 40 21
4 22 20 20 21 20 5 20 21 20 22 20 21 20 20 9 14 13 14 14 14 14 14 14 14 14 14 14 14 14 14 14 14 14 14 14 14 14 14 14 14 14 14 14 14 14 14 14 14 14 14 14 14 14 14 14 14 14 14 14 14 14 14 14 14 14 14 14 14 14 14 14 14 14 14 14 14 14 14 14
4 5 16 28 29 13 14 29 13 28 29 13 27 28 29 13 27 28 29 13 27 28 29 13 27 28 29 13 27 28 29 13 27 28 29 13 27 28 29 13 27 28 29 13 27 28 29 13 27 28 29 13 27 28 29 13 27 28 29 13 27 28 29 30 27 28 29 13 27 28 29 13 27 28 29 13 27 28 29 30
4 7 90 20 25 90 25 25 33 45 45 45 45 45 45 45 45 45 45 45 45 45 45 45 45 45 45 45 45 45 45 45 45 45 45 45 45 45 45 45 45 45 45 45 45 45 45 45 45 45 45 45 45 45 45 45 45 45 45 45 45 45 45 45 45 45 45 45 45 45 45 45 45 45 45 45 45 45 45 45
4 18 11 13 8 12 11 13 12 12 14 14 17 10 15 7 7 7 7 7 7 7 7 17 11 13 12 17 14 14 17 17 17 14 13 10
4 5 6 8 9 88 8 9 88 94 97 98 98 98 98 98 98 98 98 98 98 98 98 98 98 98 98 98 98 98 98 98 98 98 98 98 98 98 98 98 98 98 98 98 98 98 98 98 98 98 98 98 98 98 98 98 98 98 98 98 98 98 98 98 98 98 98 98 98 98 98 98 98 98 98 98 98 98 98 98
4 32 7 8 8 18 15 25 25 25 19 19 19 25 25 19 19 19 19 25 25 19 19 19 25 25 19 19 19 25 25 25 19 19 19 25 25 19 19 25 25 25 19 19 19 25 25 19 19 25 25 25 19 19 19 25 25 19 19 25 25 25 19 19 19 25 25 25 19 19 25 25 25 19 19 19 25 25 25 19
4 17 11 7 10 8 9 8 11 8 11 11 8 11 11 10 9 8 9 8 11 11 10 9 8 9 8 11 11 10 9 8 9 8 11 11 10 9 8 9 8 11 11 10 9 8 9 8 11 11 10 9 8 9 8 11 11 10 9 8 9 8 11 11 10 9 8 9 8 11 11 10 9 8 9 8 11 11 10 9
4 10 6 11 12 11 12 10 17 17 17 20 22 21 22 21 23 22 21 22 21 23 22 21 22 21 22 21 23 21 22 21 22 21 23 22 21 22 21 22 21 23 21 22 21 22 21 23 22 21 22 21 22 21 23 21 22 21 22 21 23 22 21 22 21 22 21 23 21 22 21 22 21 23 22 21 22 21 22 23
4 63 62 62 62 62 17 17 12 62 62 62 62 62 17 12 62 62 62 62 62 17 12 62 62 62 62 62 17 12 42 42 62 62 62 62 62 17 17 62 62 62 62 17 12 42 42 62 62 62 62 62 17 17 62 62 62 62 17 12 42 42 62 62 62 62 62 17 17 62 62 62 62 17 12 42 42 62 62 62
4 15 23 11 20 20 20 20 20 20 20 20 20 20 20 20 20 20 20 20 20 20 20 20 20 20 20 20 20 20 20 20 20 20 20 20 20 20 20 20 20 20 20 20 20 20 20 20 20 20 20 20 20 20 20 20 20 20 20 20 20 20 20 20 20 20 20 20 20 20 20 20 20 20 20 20 20 20 20 20
4 10 12 9 8 8 8 8 8 8 8 18 18 18 15 15 16 15 16 18 16 19 16 19 23 19 19 23 19 19 23 19 19 23 19 19 23 19 19 23 19 19 23 19 19 23 19 19 23 19 19 23 19 19 23 19 19 23 19 19 23 19 19 23 19 19 23 19 19 23 19 19 23 19 19 23 19 19 16 19
4 22 12 10 10 10 11 9 12 10 10 10 11 7 12 11 9 13 15 15 15 15 17 17 15 15 15 17 17 17 15 15 15 17 17 15 15 15 17 17 15 15 15 17 17 15 15 15 17 17 15 15 15 17 17 15 15 15 17 17 15 15 15 17 17 15 15 15 17 17 15 15 15 17 17 15 15 15 17 17
4 24 6 11 12 11 12 10 15 17 17 20 21 23 22 21 22 22 21 22 21 22 21 22 21 22 21 22 21 22 21 22 21 22 21 22 21 22 21 22 21 22 21 22 21 22 21 22 21 22 21 22 21 22 21 22 21 22 21 22 21 22 21 22 21 22 21 22 21 22 21 22 21 22 21 22 21 22 21 22
4 5 8 16 16 16 16 15 10 16 16 15 15 10 16 16 15 15 10 16 16 15 15 10 16 16 15 15 10 16 16 15 15 10 16 16 15 15 10 16 16 15 15 10 16 16 15 15 10 16 16 15 15 10 16 16 15 15 10 16 16 15 15 10 16 16 15 15 10 16 16 15 15 10 16 16 15 15 10 16
4 28 7 25 25 25 26 26 29 30 35 35 39 40 9 41 35 35 35 39 35 39 35 39 35 41 35 35 39 35 35 39 35 35 35 39 35 39 35 35 39 35 35 39 35 35 39 35 35 39 35 35 39 35 35 39 35 35 39 35 35 39 35 35 39 35 35 39 35 35 39 35 35 39 35 35 39 35 35 35
4 14 6 8 10 10 7 7 7 7 7 7 7 7 7 6 7 7 6 7 7 6 7 7 6 7 7 6 7 7 6 7 7 6 7 7 6 7 7 6 7 7 6 7 7 6 7 7 6 7 7 6 7 7 6 7 7 6 7 7 6 7 7 6 7 7 6 7 7 6 7 7 6 7 6 7 7 6 7 7
4 48 34 19 19 19 19 19 19 19 19 19 19 19 19 19 19 27 19 27 19 27 19 27 19 27 19 27 19 27 19 27 19 27 19 27 19 27 19 27 19 27 19 27 19 27 19 27 19 27 19 27 19 27 19 27 19 27 19 27 19 27 19 27 19 27 19 27 19 27 19 27 19 27 19 27 19 27 19 27
4 14 14 6 6 6 6 6 6 6 14 6 6 6 14 6 6 6 15 6 6 12 9 11 9 16 12 12 12 12 9 16 12 9
4 13 11 11 11 27 24 39 39 39 39 39 39 23 23 41 7 7 41 7 28 23 28 24 39 39 39 39 39 28 28 24 28 24 13
4 5 20 20 20 20 20 20 24 29 17 18 18 18 18 17 18 18 18 17 18 18 18 17 18 18 18 18 17 18 18 18 17 18 18 18 17 18 18 18 17 18 18 18 17 18 18 18 17 18 18 18 17 18 18 18 17 18 18 18 17 18 18 18 17 18 18 18 17 18 18 18 17 18 18 18 17 18 18 18
4 30 17 16 17 25 11 22 13 13 13 13 13 13 13 13 13 13 13 13 13 13 13 13 13 13 13 13 13 13 13 13 13 13 13 13 13 13 13 13 13 13 13 13 13 13 13 13 13 13 13 13 13 13 13 13 13 13 13 13 13 13 13 13 13 13 13 13 13 13 13 13 13 13 13 13 13 13 13 13
4 25 16 16 20 20 20 20 20 20 20 20 20 20 20 20 20 20 20 20 20 20 20 20 20 20 20 20 20 20 20 20 20 20 20 20 20 20 20 20 20 20 20 20 20 20 20 20 20 20 20 20 20 20 20 20 20 20 20 20 20 20 20 20 20 20 20 20 20 20 20 20 20 20 20 20 20 20 20 20
4 83 66 66 66 73 32 21 21 21 21 21 21 21 21 21 21 21 21 21 21 21 21 21 21 21 21 21 21 21 21 21 21 21 21 21 21 21 21 21 21 21 21 21 21 21 21 21 21 21 21 21 21 21 21 21 21 21 21 21 21 21 21 21 21 21 21 21 21 21 21 21 21 21 21 21 21 21 21 21
4 65 61 68 67 67 67 68 67 67 68 67 67 68 67 67 68 67 67 68 67 67 68 67 67 68 67 67 68 67 67 68 67 67 68 67 67 68 67 67 68 67 67 68 67 67 68 67 67 68 67 67 68 67 67 68 67 67 68 67 67 68 67 67 68 67 67 68 67 67 68 67 67 68 67 67 68 67 67 68
4 13 8 6 7 6 6 6 7 6 6 7 6 6 6 7 6 6 7 6 6 6 7 6 6 7 6 6 6 7 6 6 8 12 13
4 15 11 6 6 6 6 6 6 6 6 6 6 6 6 6 6 6 6 6 6 6 6 6 6 6 6 6 6 6 6 6 6 6 6 6 6 6 6 6 6 6 6 6 6 6 6 6 6 6 6 6 6 6 6 6 6 6 6 6 6 6 6 6 6 6 6 6 6 6 6 6 6 6 6 6 6 6 6 6
4 18 16 14 12 12 12 12 12 12 12 12 12 12 12 12 12 12 12 12 12 12 12 12 12 12 12 12 12 12 12 12 5 13 18
4 36 24 39 39 39 37 7 7 7 7 7 7 7 7 7 7 7 7 7 7 7 7 7 7 29 29 7 7 29 7 29 7 7 29 7 29 7 29 7 7 29 7 29 7 29 7 7 29 7 29 7 29 7 7 29 7 29 7 29 7 7 29 7 29 7 29 7 7 29 7 29 7 29 7 7 29 7 29 7
4 17 6 9 8 8 8 9 8 8 8 9 8 8 8 9 8 8 8 9 8 8 8 9 8 8 8 9 8 8 8 9 8 8 8 9 8 8 8 9 8 8 8 9 8 8 8 9 8 8 8 9 8 8 8 9 8 8 8 9 8 8 8 9 8 8 8 9 8 8 8 9 8 8 8 9 8 8 8 9
4 138 11 27 20 20 20 29 102 102 102 54 54 54 54 54 54 54 54 54 54 54 54 54 54 54 54 54 54 54 54 54 54 54 54 54 54 54 54 54 54 54 54 54 54 54 54 54 54 54 54 54 54 54 54 54 54 54 54 54 54 54 54 54 54 54 54 54 54 54 54 54 54 54 54 54 54 54 54 54
4 10 11 8 7 7 7 7 7 7 7 14 14 14 17 17 22 17 22 14 22 14 22 22 14 22 14 22 14 22 14 22 14 22 14 22 14 22 14 22 14 22 14 22 14 22 14 22 14 22 14 22 14 22 14 22 14 22 14 22 14 22 14 22 14 22 14 22 14 22 14 22 14 22 14 22 14 22 14 22
4 82 12 10 10 10 56 34 57 71 57 7 17 6 47 47 47 47 48 48 48 48 48 48 48 48 48 48 48 48 48 48 48 48 48 48 48 48 48 48 48 48 48 48 48 48 48 48 48 48 48 48 48 48 48 48 48 48 48 48 48 48 48 48 48 48 48 48 48 48 48 48 48 48 48 48 48 48 48 48
4 28 31 36 37 37 8 8 6 24 25 24 25 24 25 24 25 24 25 24 25 24 25 24 25 24 25 24 25 24 25 24 25 24 25 24 25 24 25 24 25 24 25 24 25 24 25 24 25 24 25 24 25 24 25 24 25 24 25 24 25 24 25 24 25 24 25 24 25 24 25 24 25 24 25 24 25 24 25 26
4 14 8 11 13 8 11 12 13 11 12 12 12 13 11 12 12 12 12 13 8 11 11 19 36 17 17 37 25 26 28 30 31 31 31 31 30 31 33 33 33 30 31 31 31 31 31 30 31 33 33 33 30 31 31 31 31 31 30 31 33 33 33 30 31 31 31 31 31 30 31 33 33 33 30 31 31 31 31 31
4 6 22 17 16 9 7 9 8 8 8 8 8 8 8 9 9 9 8 8 8 8 8 8 8 7 5 5 5 7 6 5 7 8 8 8 6
4 65 7 18 27 27 32 27 14 23 12 12 9 9 11 11 8 41 42 42 42 42 42 42 42 42 42 42 42 42 42 42 42 42 42 42 42 42 42 42 42 42 42 42 42 42 42 42 42 42 42 42 42 42 42 42 42 42 42 42 42 42 42 42 42 42 42 42 42 42 42 42 42 42 42 42 42 42 42 42
4 41 18 18 18 15 29 6 18 15 29 6 18 15 29 6 18 15 29 6 18 18 30 31 29 6 18 30 31 29 6 39 35 41
4 5 18 14 14 10 10 10 10 10 10 10 10 10 10 10 10 10 10 10 10 10 10 10 10 10 10 10 10 10 10 10 10 10 10 10 10 10 10 10 10 10 10 10 10 10 10 10 10 10 10 10 10 10 10 10 10 10 10 10 10 10 10 10 10 10 10 10 10 10 10 10 10 10 10 10 10 10 10 10
4 5 14 11 6 15 15 21 11 6 15 15 23 27 27 10 12 15 9 10 12 15 10 15 9 10 12 12 10 15 9 10 12 12 10 15 9 10 12 12 10 15 9 10 12 12 10 15 9 10 12 12 10 15 9 10 12 12 10 15 9 10 12 12 10 15 9 10 12 12 10 15 9 10 12 12 10 15 9 10
4 52 44 53 53 53 53 53 53 53 53 53 53 53 53 53 53 53 53 53 53 53 53 53 53 53 53 53 36 47 46 47 47 52
4 5 12 47 47 62 62 62 55 62 62 55 67 47 62 62 55 67 67 48 57 58 59 26 28 29 60 68 68 55 55 68 55 49 68 55 49 57 58 5
4 56 9 9 8 9 9 8 8 8 9 8 8 8 8 9 8 8 8 8 9 8 8 8 8 9 8 8 8 8 9 8 8 8 8 9 8 8 8 8 9 8 8 8 8 9 8 8 8 8 9 8 8 8 8 9 8 8 8 8 9 8 8 8 8 9 8 8 8 8 9 8 8 8 8 9 8 8 8 9
4 27 22 11 9 10 11 9 9 10 11 9 9 10 11 9 9 10 11 9 9 10 11 9 9 10 11 9 9 10 11 9 9 10 11 9 9 10 11 9 9 10 11 9 9 10 11 9 9 10 11 9 9 10 11 9 9 10 11 9 9 10 11 9 9 10 11 9 9 10 11 9 9 10 11 9 9 10 11 9
4 22 11 8 9 13 13 13 13 13 13 13 9 13 13 13 13 13 13 13 9 13 13 13 13 13 13 13 9 13 13 13 13 13 13 9 13 13 13 13 13 13 9 13 13 13 13 13 13 9 13 13 13 13 13 13 9 13 13 13 13 13 13 9 13 13 13 13 13 13 9 13 13 13 13 13 13 9 13 13
4 14 70 7 9 8 8 9 8 8 9 8 8 9 8 8 9 8 8 9 8 8 9 8 8 9 8 8 9 8 8 9 8 8 9 8 8 9 8 8 9 8 8 9 8 8 9 8 8 9 8 8 9 8 8 9 8 8 9 8 8 9 8 8 9 8 8 9 8 8 9 8 8 9 8 8 9 8 8 9
4 17 21 21 11 21 10 10 9 9 10 9 10 10 10 10 10 10 10 10 10 10 10 10 10 10 10 10 10 10 10 10 10 10 10 10 10 10 10 10 10 10 10 10 10 10 10 10 10 10 10 10 10 10 10 10 10 10 10 10 10 10 10 10 10 10 10 10 10 10 10 10 10 10 10 10 10 10 10 10
4 27 7 10 11 12 11 12 15 25 17 17 21 22 21 19 22 22 23 19 22 22 23 19 22 22 23 19 22 22 23 19 22 22 23 19 22 22 23 19 22 22 23 19 22 22 23 19 22 22 23 19 22 22 23 19 22 22 23 19 22 22 23 19 22 22 23 19 20 21 22 23 19 22 22 23 19 22 22 23
4 21 23 14 14 14 14 14 43 40 40 40 40 40 30 30 35 38 8 8 21 21 7 43 21 21 8 21 7 43 27 7 35 37
4 38 33 18 22 17 17 22 22 12 27 27 27 9 9 20 20 20 26 8 8 20 26 26 8 8 8 20 26 26 26 8 8 8 20 26 26 26 8 8 8 20 26 26 26 8 8 8 20 26 26 26 8 8 8 20 26 26 26 8 8 8 20 26 26 26 8 8 8 20 26 26 26 8 8 8 20 26 26 26
4 15 7 7 15 32 30 18 23 29 29 29 29 24 29 24 29 29 29 16 24 29 24 29 29 29 29 21 24 29 24 29 29 29 29 21 24 29 24 29 29 29 29 21 24 29 24 29 29 29 29 21 24 29 24 29 29 29 29 21 24 29 24 29 29 29 29 21 24 29 24 29 29 29 29 21 24 24 29 29
4 49 12 15 15 27 27 17 11 11 15 15 15 52 41 41 23 42 31 44 44 42 52 41 42 11 11 31 44 42 52 41 44 42
4 62 13 6 6 6 19 19 19 19 9 28 19 19 9 28 19 9 28 19 9 28 19 9 28 19 9 28 19 9 28 19 9 28 19 9 28 19 9 28 19 9 28 19 9 28 19 9 28 19 9 28 19 9 28 19 9 28 19 9 28 19 9 28 19 9 28 19 9 28 19 9 28 19 9 28 19 9 28 19
4 25 33 20 6 53 62 62 10 26 26 32 34 25 25 47 47 65 12 13 12 13 12 13 13 12 50 50 51 55 34 25 25 5
4 5 86 72 17 47 47 47 47 47 47 47 47 47 47 47 47 47 47 47 47 47 47 47 47 47 47 47 47 47 47 47 47 47 47 47 47 47 47 47 47 47 47 47 47 47 47 47 47 47 47 47 47 47 47 47 47 47 47 47 47 47 47 47 47 47 47 47 47 47 47 47 47 47 47 47 47 47 47 47
4 92 11 11 72 75 38 44 72 73 40 44 72 73 34 38 44 72 73 38 44 72 73 44 72 73 44 72 73 44 72 73 44 72 73 34
4 50 7 21 20 21 12 29 11 21 11 21 11 11 21 11 11 21 12 11 29 20 11 29 12 11 29 12 11 19 20 11 21 12 11 29 12 11 29 20 11 21 12 11 29 12 11 29 20 11 21 12 11 29 12 11 29 20 11 21 12 11 29 12 11 29 20 11 21 12 11 29 12 11 19 20 11 21 12 11
4 5 6 8 8 11 8 8 8 11 8 8 11 8 11 8 11 8 11 8 11 8 11 8 11 8 11 8 11 8 11 8 11 8 11 8 11 8 11 8 11 8 11 8 11 8 11 8 11 8 11 8 11 8 11 8 11 8 11 8 11 8 11 8 11 8 11 8 11 8 11 8 11 8 11 8 11 8 11 8
4 33 6 11 12 13 13 7 7 7 13 7 7 7 13 7 13 7 13 7 13 7 13 7 13 7 13 7 13 7 13 7 13 7 13 7 13 7 13 7 13 7 13 7 13 7 13 7 13 7 13 7 13 13 7 13 7 13 13 7 13 7 13 13 7 13 13 7 13 13 7 13 7 13 13 7 13 13 7 13
4 22 6 15 8 9 8 8 8 8 8 8 8 8 8 8 8 8 8 8 8 8 8 8 8 8 8 8 8 8 8 8 8 8 8 8 8 8 8 8 8 8 8 8 8 8 8 8 8 8 8 8 8 8 8 8 8 8 8 8 8 8 8 8 8 8 8 8 8 8 8 8 8 8 8 8 8 8 8 8
4 11 5 5 5 16 16 16 16 16 16 16 16 70 28 28 28 27 28 27 28 27 28 28 27 28 28 27 28 27 28 27 28 28 27 28 28 27 28 28 27 28 28 27 28 28 27 28 28 27 28 28 27 28 28 27 28 28 27 28 28 27 28 28 27 28 28 27 28 28 27 28 28 27 28 28 27 28 27 28
4 32 20 16 16 19 19 19 19 19 19 19 19 19 19 19 19 19 19 27 19 27 19 27 19 27 19 27 19 14 22 27 22 22 14 22 27 22 22 14 22 27 22 22 14 22 27 22 22 14 22 27 22 22 14 22 27 22 22 14 22 27 22 22 14 22 27 22 22 14 22 27 22 22 14 22 27 22 22 27
4 5 6 11 12 13 13 7 7 13 7 7 13 7 13 7 13 7 13 7 13 7 13 7 13 7 13 7 13 7 13 7 13 7 13 7 13 7 13 7 13 7 13 7 13 7 13 7 13 7 13 7 13 7 13 7 13 7 13 7 13 7 13 7 13 7 13 7 13 13 7 13 7 13 7 13 7 13 7 13
4 5 15 23 35 19 19 14 9 21 21 18 18 18 23 19 19 19 35 31 5 30 30 5 5 8 5 5 5 28 16 31 5 30 30 5
4 56 30 53 5 26 34 34 26 34 34 34 26 34 34 34 26 34 34 34 26 34 34 26 34 34 34 26 34 34 26 34 34 34 26 34 34 26 34 34 34 26 34 34 26 34 34 34 26 34 34 26 34 34 34 26 34 34 26 34 34 34 26 34 34 26 34 34 34 26 34 34 26 34 34 26 34 34 26 34
4 37 10 10 10 10 11 11 11 11 11 11 11 11 11 11 10 10 10 10 11 10 10 10 10 10 11 10 10 10 10 10 10 10 10 10 10 10 10 10 10 10 10 10 10 10 10 10 10 10 10 10 10 10 10 10 10 10 10 10 10 10 10 10 10 10 10 10 10 10 10 10 10 10 10 10 10 10 10 10
4 6 6 12 11 18 23 23 8 23 8 8 8 23 8 23 8 23 8 23 8 23 23 8 23 23 8 23 23 8 23 23 8 23 23 8 23 23 8 23 23 8 23 23 8 23 23 8 23 23 8 23 23 8 23 23 8 23 23 8 23 23 8 23 23 8 23 23 8 23 23 8 23 23 8 23 23 23 23 23
4 21 8 8 8 8 9 29 30 31 31 31 34 34 34 34 34 32 33 34 34 32 35 34 34 34 34 32 35 34 31 34 34 34 32 35 34 31 34 34 34 32 35 31 31 31 34 34 34 32 35 31 34 31 34 34 34 32 35 31 31 31 34 34 34 32 35 31 31 31 34 34 34 32 35 31 31 31 34 34
4 12 24 8 8 7 16 16 16 16 16 16 16 16 16 16 16 16 16 16 16 16 16 16 16 16 16 16 16 16 16 16 16 16 16 16 16 16 16 16 16 16 16 16 16 16 16 16 16 16 16 16 16 16 16 16 16 16 16 16 16 16 16 16 16 16 16 16 16 16 16 16 16 16 16 16 16 16 16 16
4 5 29 29 29 46 31 55 56 56 31 31 46 46 12 68 46 12 68 68 12 31 56 31 31 56 31 12 46 12 46 12 5 61 5
4 7 17 17 17 17 17 17 17 9 16 16 16 16 16 16 16 16 16 16 12 12 16 16 16 16 12 12 16 16 8 11 12 12 16 16 8 11 12 12 16 16 8 11 12 12 16 16 8 11 12 12 16 16 8 11 12 12 16 16 8 11 12 12 16 16 8 11 12 12 16 16 8 11 12 12 16 16 8 11
4 5 6 11 12 13 13 7 7 7 7 7 7 7 7 13 7 7 13 7 7 13 7 7 13 7 7 13 7 13 7 7 13 7 13 7 13 7 13 7 13 7 13 7 13 7 13 7 13 7 13 7 13 7 13 7 13 7 13 7 13 7 13 7 13 7 13 7 13 7 13 7 13 13 7 13 7 13 7 13
4 22 11 20 6 8 8 17 12 15 17 15 17 18 13 17 8 17 15 17 15 15 18 18 8 8 17 8 17 15 15 15 15 18 18 18 8 8 17 8 17 15 15 15 15 18 18 18 8 8 17 8 17 15 15 15 15 18 18 18 8 8 17 8 17 15 15 15 15 18 18 18 8 8 17 8 17 15 15 15
4 48 13 38 22 37 43 29 29 29 29 29 29 29 29 29 29 29 29 29 29 29 29 29 29 29 29 29 29 29 29 29 29 29 29 29 29 29 29 29 29 29 29 29 29 29 29 29 29 29 29 29 29 29 29 29 29 29 29 29 29 29 29 29 29 29 29 29 29 29 29 29 29 29 29 29 29 29 29 29
4 5 24 12 9 15 16 16 16 16 16 16 16 16 16 21 16 21 23 21 16 16 16 21 21 25 25 25 25 5 23 23 5 5
4 5 19 51 156 156 124 148 63 63 63 63 63 63 63 63 63 63 63 63 54 139 140 161 158 158 158 123 161 148 147 148 162 5
4 7 17 31 25 50 50 5 50 50 50 5 50 50 5 50 5 50 5 50 5 50 5 50 5 50 5 50 5 50 5 50 5 50 5 50 5 50 5 50 5 50 5 50 5 50 5 50 5 50 5 50 5 50 5 50 5 50 5 50 5 50 5 50 5 50 5 50 5 50 5 50 5 50 5 50 5 50 5 50
4 64 59 33 33 35 36 36 36 36 36 36 36 36 36 36 36 36 36 36 36 36 36 36 36 36 36 36 36 36 36 36 36 36 36 36 36 36 36 36 36 36 36 36 36 36 36 36 36 36 36 36 36 36 36 36 36 36 36 36 36 36 36 36 36 36 36 36 36 36 36 36 36 36 36 36 36 36 36 36
4 38 21 7 7 7 7 7 7 7 7 7 7 7 7 7 7 7 7 7 7 7 7 7 7 7 7 7 7 7 7 7 7 7 7 7 7 7 7 7 7 7 7 7 7 7 7 7 7 7 7 7 7 7 7 7 7 7 7 7 7 7 7 7 7 7 7 7 7 7 7 7 7 7 7 7 7 7 7 15
4 21 6 7 7 8 8 8 8 8 8 8 8 8 8 8 8 8 8 8 8 8 8 8 8 8 8 8 8 8 8 8 8 8 8 8 8 8 8 8 8 8 8 8 8 8 8 8 8 8 8 8 8 8 8 8 8 8 8 8 8 8 8 8 8 8 8 8 8 8 8 8 8 8 8 8 8 8 8 8
4 58 50 6 6 6 24 74 74 74 24 74 74 74 75 74 74 74 74 75 74 74 74 74 74 74 74 74 74 75 74 74 74 74 74 74 74 74 74 74 74 74 74 74 74 74 74 74 74 74 74 74 74 74 74 74 74 74 74 74 74 74 74 74 74 74 74 74 74 74 74 74 74 74 74 74 74 74 74 74
4 143 10 134 134 19 105 105 51 26 92 74 92 55 92 68 49 92 49 39 51 49 49 49 10 10 148 143 143 181 148 143 143 173 5
4 20 6 13 5 9 5 7 5 7 5 10 5 7 5 7 5 7 5 7 5 7 5 7 5 7 5 7 5 7 5 7 5 7 5 7 5 7 5 7 5 7 5 7 5 7 5 7 5 7 5 7 5 7 5 7 5 7 5 7 5 7 5 7 5 7 5 7 5 7 5 7 5 7 5 7 5 7 5 9
